ચોર્યો	The thief
શોલ્ડરમાં	In Shoulder
ગાલા	Gala
વિધિથી	By ritual
રિઝલ્ટ	Result
પૉઇન્ટનો	points
માધુરીના	Madhuri's
પટેલે	Patel
સયાજીરાવ	Sayajirao
મોઘી	Moghi
ટેવ	habit
જરા	Just a little
ઇશાએ	Isha
સુધીનો	Up to
ડાઉનઃ	Down:
વોરંટ	Warrant
દી	the
પહોચ્યા	Arrived
અક્ષય	Akshay
લાજવાબ	Awesome
નેહા	Neha
ઉથલ	Uthal
મહાન	Great
ખાનને	Khan
ધાકડ	Dhakad
વ્હિલર્સ	Wheelers
હેચબેક	hatchback
પત્નીનું	of the wife
બેફિકર	Befikre
યુનિવર્સ	Universes
ચંદ્રશેખરની	Chandrasekhar's
હોલીવૂડ	Hollywood
સાયકલિંગનો	Of cycling
સોનાનો	of gold
છોરો	Boys
અર્થવ્યવસ્થાએ	the economy
કર્યો	did
નાઇટ	Night
ગ્રામથી	From gram
બેઠક	Meeting
થઇને	by
7મા	7th
ફ્રીમા	Freema
લેવાઈ	taken
બોલી	dialect
નોકરીયાત	Employed
ચોર્યુ	The Thief
ફૂલઓન	Fullon
ઇન્સ્ટોલ	Installed
કેન્સરનાં	of cancer
ભુખ્યા	hungry
હૃતિક	Hrithik
રાજકોટઃભાવમાં	Rajkot: In bhavma
રક્ષા	Defense
ઈઝરાયલના	Of Israel
સૂચક	Indicator
પડેગા	Padega
દબાણની	of pressure
આકાશમાં	in the sky
રેમ્પ	Ramp
ભેટમાં	In a gift
બાયોપિકનો	of the biopic
મજાકિયા	Funny
રજા	Leave
શાઓમીનો	Xiaomi's
ગર્જ્યા	Roaring
લેમ્બોર્ગિની	Lamborghini
શ્રેયા	Shreya
વિતી	Viti
વાગ્યાથી	From o'clock
સળીથી	from the stick
બાંધ્યો	Tied up
રેમ્પવોક	Rampwalk
માંગણી	Demand
નીકળ્યો	left
કરાઈ	Done
ફાઇવ	Five
લીટર	Liter
સિન્હા	Sinha
ક્યારે	when
ડિલીવરી	Delivery
બનાવીને	by creating
સ્ટુડિયોમાં	In the studio
શાસ્ત્રી	Shastri
ભાદુરીનું	Bhaduri's
52500માં	In 52500
ફીચર્સની	Features
ચોકાવનારો	Starters
નવજોત	Navjot
મંત્રાલય	Ministry
વધ્યાપેટ્રોલ	Increased Petrol
કેટરિના	Katrina
સમક્ષ	In front of
હેરાન	Heran
130મા	130th
પેનલનો	Panel's
માંગો	Want to
સિલસિલા	Silsila
ખેડૂતોનો	of the farmers
માર્કેટમાં	in the market
ડ્રાઈવ	Drive
ચઢ્યો	Climbed
આત્મહત્યાની	of suicide
સનીનાં	Sunny's
પત્થરબાજી	stone pelting
એક્સેલન્સ	Excellence
સરકારે	Government
ટેટૂ	Tattoo
પતિની	husband's
દેઓલ	Deol
બગડી	Spoiled
દેવગનથી	From Devgan
બ્રુનાએ	Bruna
સાવ	Absolutely
પ્રતિક્રિયા	Reaction
250માં	In 250
હટ્યો	Removed
દશેરાની	Dashera
ડીલ	Deal
રણબીરે	Ranbir
પડદા	Curtains
મીનિટ	Mint
કેમેરાની	of the camera
ફોન	Phone
ગ્રૃપમાં	In the group
વિંટી	Vinty
તોડ	Break
અંડર	Under
રોડ	Road
પિયુષ	Piyush
હતાં	were
સિંદુર	Sindoor
અજય	Ajay
ફ્રેન્ડે	Friend
વસ્તું	Things
પ્લાન્ટ	Plant
બતાવવું	Show
આપનારા	Giver
આવેલી	Incoming
કપાસની	of cotton
વ્યાજે	interest
મનની	of the mind
ખટાવાની	Khatawani
રજનીકાંત	Rajinikanth
નામે	In name
માટેનું	for
પ્રભાવથી	by effect
નાખ્યો	dropped
લાઈસન્સ	License
પ્રક્રિયા	process
શોધવાની	To find
મૌન	Silence
સમા	Sama
સરલા	Sarla
થરૂરે	Tharoor
વધીને	Growing up
ઉર્મિલાનાં	Urmila's
પીરામલની	Of Piramal
આરઆઈએલ	RIL
અબરામે	AbRame
નથી	Is not
આરબીઆઇનો	OF THE RBI
ચોર્યાસી	Choryasi
યુઝર્સનો	of the users
ઇન્ડો	Indo
દૂકાન	Dukan
અવસર	Opportunity
આક્ષેપ	Allegations
સંજોગોમાં	Under the circumstances
આલિશાન	Alishan
બોલિવૂડની	Of Bollywood
2016નો	Of 2016
સિક્યોરિટી	Security
કરાવવાનું	To get it done
કેદારનાથ	Kedarnath
એનફિલ્ડ	Anfield
રતન	Ratan
રજૂ	Presented
સેન્સને	to sans
રાહતઃઆજથી	Relief: From today
ભાભીજી	Bhabhiji
મોડાસાઃમગફળીના	Modasa: Peanuts
સિમ્બા’	Simba'
દંગલ	Dangal
ફાઈનલી	Finale
તુસાદ	Tussauds
રેતીના	Of sand
સાર્વજનિક	Public
ઢગલાબંધ	heaped
જોનસને	To Jonas
રંગ	Color
મુરિલ્લો	Muriello
હમશકલ	Humshakals
હિનાએ	Hina
ઇચ્છા	Desire
ભોયરૂ	Bhoyru
ટિકા	Tica
પટેલના	Patel
ફોનનો	of the phone
નોટને	To the note
વાપરવાનો	To use
આઉટફિટમં	In the outfit
વલસાડ	Valsad
જશોદાબેનનો	Of Jashodaben
ઠાઠમાં	In the throes
છતા	However,
મોમેન્ટ્સ	Moments
કુવારો	Wells
કુરૈશીએ	Quraishi
પડી	fell
પંચ	Punch
ઘટતા	decreasing
તસીવરો	Tasivros
અર્જુને	To Arjuna
આસામી	Assamese
સાથે	With
પાક	Crop
ચોંકી	Shocked
ધનતેરસ	Dhanteras
કરોડને	to crores
એસ્ટેટ	Estate
હટાવ્યું	Removed
રોકડ	Cash
ચેતજો	Warnings
ડાયના	Diana
કરાવતી	Getting it done
આંખો	Eyes
રસ્તાઓ	Roads
બારટેન્ડર	Bartender
હીરોઈન	Heroine
ડેરીમાં	In dairy
બ્રાંચમાં	In The Branch
ઇસરો	ISRO
12નાં	of 12
બેરોજગારો	Unemployed
ઠીક	All right
નિભાવનારી	executing
ઇસ્સરને	Issar
માફીના	Apologies
ઘટાડ્યો	Reduced
પ્રધાન	Minister
અપડેટ્સ	Updates
પાઠ	Text
પેસેન્જરનું	of the passenger
ડેંગ્યૂ	dengue
દેખાશે	Will appear
યુવકે	Young man
જુલાઇ	July
મેમ્બર્સ	Members
ફોટા	Photos
પડ્યા	fell
રેસ	Race
મેલે	Mele
નોટઃજુવો	Note: See
તેમને	them
એજન્સીના	of the agency
જુએ	Look at
ઉદ્ઘાટન	Inauguration
આલિયાની	Of Alia
ગોલ્ડીનો	Goldie's
રુપિયામાં	in rupees
વેમ્પ	Vamp
ડાન્સ	Dance
પાત્રનું	of the character
ભાઇઓ	Brothers
ઈંધણ	Fuel
પોઇન્ટનું	of the point
વિશ્વનો	of the world
છિલ્લરની	Chhillar's
અમેઝ	Amaze
કેન્દ્રને	To the Center
તૈમૂર	Taimur
અટકાવી	Stopped
ઓળખીને	By identifying
જોઇએ	Should
જીવન	life
ટીવી	TV
રિલાયન્સનો	Of Reliance
નજારો	Views
ટ્રાફિક	Traffic
ઢગ્સ	Dumps
નિફ્ટી	Nifty
શર્માનાં	Sharma's
રોકડની	of cash
ચૌધરીના	Chaudhary's
રામપાલની	Rampal's
નુક્સાન	Nuxan
સાઇડ	Side
શ્રેયસ	Shreyas
12મા	12th
પટાખા	Pataakha
તસવીરોમાં	in pictures
માંથી	From
વેન્ટેજ	Vantage
એક્સિસ	Axis
ડબ્બામાં	In the box
બાંધીને	Tied up
અબ્દુલાએ	Abdullaha
ઓડિશા	Odisha
પછાડી	Knocked down
ઉઠમણું	Rise up
અભિનેત્રીનું	Of the actress
મલ્હાર	Malhar
પરનો	On
ડીલઃ	Deal:
રાજકોટઃઆરોગ્યના	Rajkot: Healthy
સાઉથની	Of the South
ડાર્કવેબ	Darkweb
અમારા	our
રહેજો	Stay tuned
ફ્લેટમાં	in the flat
આપણી	our
સૂનિલ	Sunil
વાઇફે	Wife
કિસિંગ	Kissing
દેખાડશે	Will show
જેલ	Jail
સક્સેસથી	From Sussex
બોલીવુડના	Bollywood
સુરતનો	Of Surat
ઇન્ટરનેટનું	of the Internet
ભાગ્યની	of fate
સેટિંગ્સ	Settings
ગેરંટીના	Guaranteed
વળતર	Compensation
ક્લેમ	Claim
હનીમૂનની	Of the honeymoon
મંગલસૂત્ર	Mangalsutra
કપડા	Clothes
રાતનો	of the night
એન્ગેજમેન્ટ	Engagement
વીકએન્ડમાં	Over the weekend
ખલબલી	Khalbali
દીવાળી	Diwali
બાપ્પાનાં	Bappa's
નજીકના	Nearby
રાજ્યપાલના	Governor's
સ્વીકારાશે	will be accepted
અભદ્ર	Rude
દાળના	dal
સમાજસેવાનો	Of social service
રહ્યુ	has been
મેકર્સે	The makers
સોનમને	To Sonam
પ્રોબલમ	Probalum
રજાઓના	Holidays
જેકી	Jackie
હાથીને	to the elephant
મચાવ્યો	created
રીટેલર્સની	Retailers
ગ્રૂપમાં	In group
મળતું	Found
બદલાયા	Changed
બાહુબલીનો	Of Baahubali
નોકરીયાતો	Employees
સ્કુટર	scooter
અનૂપમ	Anupam
બ્લડપ્રેશર	Blood Pressure
મૂર્તિ	idol
રિસર્ચ	Research
હાલત	State of Affairs
ગુજ્યા	Gujya
નિયમોમાં	in the rules
ફંક્શનમાં	In function
ભરેલી	Full
2021માં	In 2021
વાતની	Talk about
સિંહના	Lion's
પૂજા	Puja
વિરોધી	Opponents
વ્હોટ્સએપથી	From WhatsApp
ઇન્ડિયાએ	India
લિયોને	To Leo
દિક્ષીત	Dixit
એલર્ટ	Alert
આઈડિયા	Idea
લીક	Leaks
ફઝલના	Fazlna
સુપરહિરો	Superhero
ઇન્કાર	Denial
ગરીબોને	to the poor
એવી	Such is the case
સુવા	Sleep
બેદીને	Bedi
રિશી	Rishi
કોલથી	By call
શોષણનો	of exploitation
સિંહે	Singh
મંદિરાના	Mandirana
લંબાવાઇ	Extended
દિખલા	Dikhla
શરત	Condition
પોતાને	himself
પૂલનાં	of the pool
વીડિયોકોને	Videocone
રાજકોટઃ	Rajkot:
જામતા	Jamta
પેટ્રોલિંગ	Patrolling
બહેનના	sister's
ફ્લાઈટની	of the flight
ટ્યૂમર	Tumor
નહી	No
પ્રભાકર	Prabhakar
ઓપરેટિંગ	Operating
સીધુ	Straight away
પડકારશે	will challenge
કરીશ	I'll do it
મોડલની	of the model
નાગા	Nagas
યુઝ	Use
નાણાંનો	of money
પૂનમને	To Poonam
સ્ટ્રેટનર	Stratner
ખરીદ્યુ	Purchased
લાગુ	Applicable
કમાલની	Kamal's
સેવિંગ્સ	Savings
સિક્રેટ્સ	Secrets
શક્તિકાંત	Shaktikanta
આસારામની	Asaram's
પ્રતિક	Symbol
એક્ટિંગ	Acting
ઓડી	Audi
બિલી	Billy
ઇન્ટરપોલે	Interpol
રુમ	Room
સુહાના	Suhana
જવું	go
ફિલ્મ	Film
ગફલત	Gufflat
મોડુ	Late
એપ્પલના	Apple's
મન્નતને	Mannatne
કલાકાંડી	Ghantaandi
સોંઘુ	Songhu
આવતી	Coming
મર્ચન્ટે	Merchant
નિકનો	Nick's
ઘરનો	Home
ડ્રાયર	Dryer
ક્રિસમસ	Christmas
છો	you are
આસિસ્ટન્ટ	Assistant
ચહેરો	face
શુ	What
ધારાસભ્યની	MLA's
ફેલાવતા	Spreading
ડિરેક્ટરની	Director's
200માં	In 200
શહીદીના	Martyrdom
ડિટેઇલ	Details
શાખામાં	In branch
સાઇન	Sign
આશા	hope
21કિ	21ki
પ્રસારણની	of broadcasting
શાહિદનાં	Shahid's
તવાહીઃજોઓ	Tawahi:
રે	Ray
છેતરાય	Cheating
ધરમેન્દ્ર	Dharmendra
રાણી	Queen
ચમકાવવા	to shine
હૂ઼ડીની	Hoodini
કેસમાં	In the case
38કરોડના	38 crores
હાથમાં	In hand
પુરવઠો	Supplies
2માં	In 2
ભાઈ	Brother
તમારે	You have
અમદાવાદઃ	Ahmedabad:
ઈન્ડેક્સમાં	In the index
સેવાઓ	Services
મોમ	Mom
1પર	At 1
દેવગનને	To Devgan
સીટર	Sitter
પગે	On foot
એપ્રિલથી	From April
આઝાદી	Freedom
કર્યાં	done
અઠવાડિયા	Weeks
ફાર્મિંગ	Farming
વિદ્યાર્થીની	student
હનિમૂન	Honeymoon
શકવાની	to be able to
પહેલું	first
ઉપાડવાની	To pick up
1ના	of 1
ઉપાડવા	To pick up
ઇટલીમાં	in Italy
કઈંક	Something
મંદાકીની	Mandakini
સંજના	Sanjana
આયોગ	Commission
શાહને	Shah
મર્યાદા	Limit
મરજી	will
ગ્લેમર	Glamour
લગ્ઝુરિયસ	Lagzurias
પૈસા	The money
ખાને	Khane
કોહલીની	Kohli's
જાપાનને	To Japan
ચક્કરમાં	in a circle
ગદ્દાર	Gaddar
પ્રિયંકાનું	Priyanka's
મળીને	Together
પૂર	flood
સમાન	Similar
કોર્ટમાં	in court
શેનાથી	From what
સૂરમા	Surma
ઝઘડો	quarrel
રબારીને	Rabari
નાચશે	will dance
વિનર	Winner
આવો	Come on
ફિલ્મોની	Films
તેનાં	His
પાર્વતી	Parvati
લાખોમાં	in lakhs
તાન્યાએ	Tanya
લોકોની	people
વેડિંગ	Wedding
તદ્દન	Quite
3નાં	of 3
યુઝર	User
રિપેરિંગ	Repairing
ભૂલો	Errors
વિતાવવી	to spend
બેબોની	Beboni
ડિસ્કાઉન્ટ	Discounts
ઓફિશિયલ	Official
ચેતાવણી	Warning
સોનમની	Sonam's
અનામત	Reserved
શહેરવાસીઓને	To the city dwellers
હોટલ	Hotel
પ્રસંગે	On the occasion
સ્ટ્રાઇક	Strike
ઇધણ	Idhaan
કિરદારમાં	In Kirdar
ડો	Dr.
ઓરિયેન્ટલ	Oriental
વેચાશે	will be sold
એશ્વર્યાનો	Aishwarya's
સિલિન્ડરઃ	Cylinder:
પ્રેમમાં	In love
ડોઝ	Dosage
આપવામાં	Given
મિસ્ત્રીના	Mistry's
ઓબઝર્વેશનમાં	In observation
પરિવાર	family
આધારકાર્ડમાં	In Aadhar card
10700ની	10700
કંપનીઓ	Companies
પૂછી	Asked
કુતરો	Dogs
ડર	Fear
કાળુ	Black
ઘરેણા	Jewelry
રાજીથી	Pleased
દેશભરમાં	across the country
ભાવમાંથી	From price
આપનું	Yours
લોગોમાં	In Logo
ફરતો	Moving around
ટ્રીબ્યુટ	Tribute
આહા	Aha
સ્ક્રિનિંગ	Screening
રોમાન્સ	Romance
કોમરેડ	Comrade
મજ્જો	Marrow
સલામત	Safe
ચાવી	The key
ગાંધી	Gandhi
ગાઉન	Gown
દુલ્હનની	of the bride
ડાયલ	Dial
વધ્યુ	increased
રેશમાની	Reshma's
બ્રોડબેન્ડ	Broadband
રણવીરને	To Ranveer
ઢિંચાક	Dhinchak
મોદીએ	Modi
રિએક્શન	Reaction
શમા	Shama
ખાય	Eats
લાવ્યા	Brought
નોંધાયા	Registered
ફેસબૂક	Facebook
અબજોની	of billions
કી	Key
અનુષ્કા	Anushka
ડેટ	Date
નોરા	Nora
રોચક	Interesting
ટ્રાવેલર	Traveler
અક્કીનો	Of Akki
લિપ્સ્ટિકમાં	In lipstick
ફિલ્મો	Movies
મજબૂર	forced
આશ્કાએ	Aashka
ગૂપચૂપ	Secretly
બેઠકમાં	In the meeting
બેંકોમાં	in banks
ધોની	Dhoni
એક્ટિવ	Active
કૈસે	Kaise
આલા	Aala
લવ	Love
ભાવમાં	In Price
એમેઝોને	To Amazon
રાજપૂતને	To Rajput
કૂકે	Cooke
માલિકોની	of the owners
તારીખોમાં	In Dates
ફોટોનું	Photo of
જનરલ	General
કલાકોમાં	within hours
જમાવી	deployed
છઠ્ઠી	Sixth
પગમાં	In the legs
પાસેથી	from
હોવાથી	Being
એક્શનમાં	in action
સોન્ગ	Song
સેનાનો	of the army
અરે	Hey
દિવસોમાં	in days
બિઝનેશમેન	Businessman
કિમી	Kimi
યરનો	year's
પહોચ્યો	Arrived
છપાશે	will be printed
સરકારની	Government
મિત્રને	to a friend
ડેટાની	of data
અપીલ	Appeal
લેવડદેવડ	Transactions
ક્રેશ	Crash
બેલેન્સ	Balance
મોટુ	Big
મળવા	To meet
ગરીબોનું	of the poor
બિકીનીમાં	In a bikini
પેકેજ	Package
ડૂબે	drowning
શાન	Shan
રહેવાની	To stay
10620ની	Of 10620
પ્રતિબંધ	Ban
ડાંગર	Paddy
અંદાજને	Estimate
છેડછાડ	Tampering
ડિલિટ	Delete
પિન્કી	Pinky
રિસોર્ટનું	of the resort
લલચામણી	Lalchamani
જેમાં	in which
રોગી	Patient
સરનામું	Address
બન્યા	became
ગયેલી	Gone
ગયું	Gone
થવા	to be
ખોવાઈ	Lost
જીયોએ	Jio
બિહારી	Bihari
ટ્વિટને	To the tweet
કે	or
લાલ	red
મલ્હોત્રાનાં	Malhotra's
અમદાવાદની	Ahmedabad
હિઝાબ	Hijab
ઘરેલું	Domestic
અભરાઇએ	Abharaiye
દિવસો	days
ખાસીયતો	Specialties
છેઃજોઓ	:
વોટ્સએપને	To WhatsApp
તણાવ	Stress
ઘટવાની	decreasing
એક્તા	Ekta
લડવાની	To fight
સરવે	Survey
દર્દી	Patient
છુપાવતી	Hiding
ડૂબી	drowned
પટનીએ	Patni
મિનીટે	Minutee
વોટ્સએપે	WhatsApp
દિવાના	Diwana
બોલવા	To speak
ખાઈ	eating
વ્યક્તિને	to the person
બ્લોકચેન	Blockchain
પોસ્ટરથી	from the poster
રાજકોટઃએક્સાઇઝ	Rajkot: Excise
બેન્ક	Bank
પ્રભાવ	Effect
દુનિયા	universe
મૂડીપ્રવાહ	Capital inflow
પહેલાની	Previous
મોડલ	Model
લંડનમાં	In London
એની	Annie
રમેશ	Ramesh
કિમતનો	prices
રેકી	Reiki
આનંદનાં	of joy
છુપાવી	Hidden
મોહભંગ	Infatuation
તૈયાારીઓ	Tayyario
હીરોઈને	To the heroine
હનીમૂન	Honeymoon
હોન્ડાએ	Honda
ટ્રિક	Trick
ચિંમકી	Chimki
પોઈન્ટ	Point
ફેક	Fake
ડિસ્કવરી	Discovery
સમિટઃશિક્ષણ	Summit: Education
દેશની	of the country
ધરાવતી	possessing
લાઇક્સ	Likes
નાંખતો	Throwing
પીડાતી	afflicting
આવા	Such
ભારતનું	Of India
આધારકાર્ડની	Of The Aadhaar Card
શાખા	branch
સ્તનને	to the breast
અચાનક	Suddenly
દવાઓ	Medicines
કહાણી	Story
પલ્લુ	Pallu
કિંગફિશર	Kingfisher
સરકારથી	from the government
પ્રીપેડ	Prepaid
લાગ્યા	It took
બજેટની	Budget
કોણ	who
સોલાર	Solar
માહિરાએ	Mahira
રજત	Rajat
સ્પેસિફિકેશન	Specification
2490માં	In 2490
નહેરૂ	Nehru
રાષ્ટ્રવ્યાપી	Nationwide
ગવર્નરને	to the Governor
સિસ્ટમથી	from the system
વર્ગ	Class
ફાઇ	Fi
ઘીના	Ghina
થથરે	Thathere
સુપ્રિમ	Supreme
પરીક્ષણ	Testing
જોબનું	of the job
લોન્સ	Loans
યુઝર્સ	Users
થવાનું	to be
વાઇ	Wai
1994માં	In 1994
બન્યું	happened
રડતી	Crying
એપીએમસીના	OF APMC
ગીતકાર	Lyricist
પતંજલીમાં	In Patanjali
બતાવશો	Show
રોપ	Rope
કાલે	Tomorrow
માથાનો	head
વિરાટતાના	of greatness
3ના	of 3
ડ્રીન્ક	Drink
રોવાનું	Crying
ઓનલાઈન	Online
ઉપયોગ	Use
સ્પીડ	Speed
જશેઃ	Will go:
વિષય	matter
નજરે	Look at
સલમાનનાં	Salman's
તૂફાન	Toofan
બનાવવી	Creating
નજીવી	Minor
ફ્રી	Free
ફોર્મ	Form
શ્રદ્ધાએ	Faith
સર્ક્યુલેશનમાં	in circulation
ઇકોનોમી	Economy
ટેક્સમાં	in taxes
નંબરે	Number
ડ્રાઇવરે	The driver
એરવેઝ	Airways
તાલ	Taal
પ્રોજેકટ	Project
ગિઝેલે	Giselle
હજારોનો	of thousands
જલાતા	Jalata
અત્યાધુનિક	State-of-the
બેન્કના	Of the Bank
ખેતી	Agriculture
એચિવમેન્ટ	Achievement
અમલ	Implementation
અધુના	Adhuna
ગોવાનાં	Of Goa
સુરતઃરાંદેર	Surat: Rander
અહેવાલથી	From the report
કવર	Cover
ડ્રેસની	of the dress
ફરી	Again
આંકડાનો	of statistics
સ્વીટ	Sweet
સ્ટારકાસ્ટનો	of the starcast
મુંબઇ	Mumbai
ટાટાના	Tata's
ચાહકો	Fans
વિવાદોનાં	of disputes
પોપ્યુલારિટીમાં	In popularity
2000નું	Of 2000
29હજારની	29,000
તેવા	Such as
જગજાહેર	World Public
ઓટો	Auto
કેરેક્ટર	Character
ઓફર્સ	Offers
હસીના	Hasina
માર્વલ્સની	Marvels
ચીન	China
ફોર્બ્સ	Forbes
રોકાઇ	Rokai
પીરિયડ	Period
પરમારની	Parmar's
અજાણી	Unknown
પિરામલ	Piramal
શરમ	Shame
ટાયકૂન	Tycoon
ગણાવી	Counted
વીડિયોએ	Video
અહીં	Here
ટાઇગર	Tiger
નાવી	Navi
હજારનું	of a thousand
ભાવેશ	Bhavesh
સ્નેપચેટને	To Snapchat
પીડાતા	suffering
આમિરની	Aamir's
કરણનો	Karan's
વીઝા	Visa
ફેરા	Fera
સલમાનથી	From Salman
મોકલનારને	to the sender
પાંખીયાવાળા	Winged ones
ઉડતી	Flying
વાળાને	To the one
લખ્યું	Wrote
ઓપન	Open
વર્જિનીટી	Virginity
ઘેરી	dark
શોધો	Search
કેન્સરથી	from cancer
ખુરાનાની	Khurana's
ક્વોન્ટિકો	Quantico
દિવાળીમાં	In Diwali
શહેરના	city
ખરી	True
કોમોલિકાને	To Komolika
શિયોમીની	Xiaomini
વાજપેયીના	Vajpayee's
રહેમાન	Rahman
ઇમેલ	E-mail
ગ્રોથ	Growth
બેંગલોરઃ	Bangalore:
મોંઘું	costly
વસ્તુઓની	Things
કંપનીએ	The company
વહુએ	daughter-in-law
ટપકસિંચાઇ	Drip irrigation
લાતોથી	From the kicks
તે	It
રાખવામાં	kept
બીજાના	of others
નડી	Nadi
વિધાનસભામાં	In the Legislative Assembly
રોકવા	To stop
પ્રવેશ્યું	Logged in
રામદેવના	Ramdev's
ખન્ના	Khanna
ભૂલી	Forgot
રણમાં	in the desert
વાળ	hair
સન	Sun
વેપારીઓએ	Traders
કરિયાણાની	grocery
એકટ્રેસનો	Of the actress
બ્લૂ	Blue
પાદુકોણને	To Padukone
ટકરાશે	will collide
મોંઘી	Expensive
હોશ	Hosh
ડુબ્યા	drowned
ખરીદવાનો	To buy
શાહે	Shahe
પ્લેનમાં	In the plane
રદ	Canceled
નવો	New
અમૂલ	Amul
લાખોનો	of millions
સુવિધાથી	from the facility
વિમો	Vimo
એક્સ્ટ્રા	Extra
છેતરપિંડીનું	of fraud
બોયકોટની	Boycott's
રાવનું	Rao's
સફારી	Safari
હલચલ	Movement
ઘોડો	horse
લિયોનનો	Lyon's
ઈયરફોન્સ	Earphones
સ્મગલિંગનો	of smudging
રત્નકલાકારોની	of the jewelers
તસવીરને	To the picture
પીયૂષ	Piyush
તબક્કે	At the stage
જેઠાણી	Jethani
ભંગ	Breach
જીતી	Won
મહેંદીથી	from mehndi
અઠવાડિયામાં	in a week
સનીએ	Sunny
પોપ	The Pope
ડ્રોનના	of drones
ભગવાનના	God's
ગુજરાતઃ	Gujarat:
પ્રજાએ	the people
નાણા	Finance
ચુકાદા	Verdict
પહોંચે	Arrives
ઓટોમેટિક	Automatic
મિશા	Misha
અખાદ્ય	Inedible
કરણ	Karan
આપે	You give
એક્ટર્સ	Actors
કેમરોક	Camrock
મેવાણી	Mevani
બેન્દ્રેએ	Bendre
મોબાઇલથી	From mobile
રંગીલા	Rangila
91મી	91st
મહિલાઓએ	women
નીક	Nick
પાડવાના	to fall
લિન્ક	Link
સ્ટેટમેન્ટ્સ	Statements
છોકરાની	of the boy
નરગિસ	Nargis
મુગટ	Mugat
તેનો	His
પ્રતિ	Per
ઉઠી	Get up
રુ	Rs.
બહેનને	To the sister
પરી	Fairy
લાઇટ	Light
જાસૂસ	Detective
પરિવારોની	of families
તફાવત	Difference
ઊંચા	High
અગ્રવાલનું	Agarwal's
નીકળે	out
હોળીમાં	In Holi
ડરાવી	Scary
વેડિંગનું	Of the wedding
અવોર્ડ	Awards
અર્થતંત્ર	Economy
બીએફએફ	BFF
સુપરમેન	Superman
ઘટ્યા	decreased
ફિલ્મમેકર્સ	Filmmakers
સોફ્ટવેર	Software
ડીઝલનો	of diesel
એકસ્ટ્રા	Extra
પ્રિંટીંગનો	of printing
રાની	Rani
શ્રીવાસ્તવ	Shrivastava
શેટ્ટીના	Shetty's
ધો	Dho
રીલિઝ	Release
જાન્યુઆરી	January
મિનિટોમાં	In minutes
સજી	Saji
ન્હાતી	bathing
ચોપડાની	Chopra's
મોહિની	Mohini
વર્ષીય	year
ટોકટાઇમવાળો	Talktime ones
નાસ	Nass
નાની	Small
ડિમાન્ડ	Demand
ભાસ્કર	Bhaskar
પોતાના	his own
કિંમતી	Valuable
ફવાદ	Fawad
ખોલવી	Opening
તસવીરો	Photos
અઢી	Two and a half
આતંકવાદી	Terrorist
દેજો	Dejo
775કરોડ	775 crore
દિકરો	Son
જોખમમાં	At risk
ગ્રેચ્યુઇટી	Gratuity
વધારે	more
અગ્રવાલે	Agarwal
સિંહની	of the lion
55માં	In 55
ઈશાએ	Isha
રાજીનામાં	resignation
20ની	Of 20
અભિષેકે	Abhishek
જેનાંથી	from which
11ના	Of 11
રેણુકા	Renuka
ટ્રાન્ઝેક્શન	Transactions
મોડી	Late
ડેબ્યૂ	Debut
મોખરે	At the top
મોબાઇલને	to mobile
સ્થિતી	Status
ફૂડ	Food
ખુદાબક્ષ	Khudabaksh
દેવીના	Devina
બોલબાલાઃ	Bolbala:
લાગશો	Feel like
સિઝનમાં	in the season
રાખજો	Keep it
પાંચમી	Fifth
જીજાની	Jijani
મીડિયાને	To the media
કેપેસીટી	Capacity
માગોને	To Ask
લગ્નનો	of marriage
કપાડિયાને	To Kapadia
કુમાર	Kumar
મૃત	dead
નંબરની	Number of
જીઓ	Geo
કૂદીને	by jumping
બજાર	market
આફ્રિકાનાં	Of Africa
દેખાય	Visible
ડુંગરી	Dungari
ફાળ્કે	Aalke
કંટ્રોલ	Control
પૈસાનું	of money
પાણીનો	Water
સાધ્યું	Sadhya
જવાનોના	of the jawans
ડિપાર્ટમેન્ટે	Department
મેરેટિયલ	Meratrial
લતાજીનું	Lataji's
જાણકારીઓ	Information
અણીયારા	Aniyara
સીક્રેટ	Secret
ટ્રાઈની	Trai's
વ્યાજદર	Interest Rate
નિધનથી	From death
ભટ્ટનો	Bhatt's
પ્રેરણાદાયી	Inspirational
આપ્યાં	given
ઈંસ્ટાગ્રામ	Instagram
ટેક	Tech Tech
ધનવાનો	The rich
શિવાયથી	Shivayathi
ઘટી	decreased
લીટરેચર	Literature
નકાર્યા	Rejected
આઈકન’	Icon'
10મીએ	On the 10th
ગરબો	Garbo
અક્ષરોથી	By Characters
વાંચો	Read it
નાગરીકને	to the citizen
સંબંધોની	of relationships
ઉમરમાં	in age
ખાતો	Eating
ડીઝલની	of diesel
સેઠે	Sethe
પાંડે	Pandey
મૃતદેહ	Body
રીંગ	Ring
કેદ	Imprisonment
માર્કેટીંગ	Marketing
પાનકાર્ડની	OF PAN CARD
કૌન	Kaun
કામકાજ	Work
બંને	both
ફીચર્સ	Features
કોનો	Whose
એલજીનો	LG's
પત્નીથી	from wife
અનુષ્કાનો	Anushka's
મિલન	Milan
લગાવનારી	Impostor
જાસૂસી	Espionage
વેકેશનમાં	On vacation
ગલી	Street
બળાત્કારી	Rapist
નાણાસંસ્થાઓએ	financial institutions
જરુર	Necessary
ગયો	Gone
હતો	was
એકટરની	of the actor
શ્રીદેવીનાં	Of Sridevi
નંબરથી	By number
તેટલા	As much as
પ	p
પહોંચી	arrived
પ્રભુતામાં	in the Lord
ડે	Day
ખતરનાક	Dangerous
અગ્નિપથ	Agneepath
હિજરત	Migration
કોઇપણનું	of anyone
1344મકાનોનો	1344 Of The Macano
પદો	Positions
દિકરીઓને	Daughters
બિલ્ડરની	the builder's
ક્રિસ્ટલના	Crystal's
ઘસાઈ	Dragging
ચમેલી	Chameli
ફૂંકશે	will blow
કહેતા	saying
સામાન્ય	common
તસ્વીર	Photo
ઇન્સ્ટાગ્રામે	On Instagram
ખુશીનો	Of happiness
કરાવવાને	To get it done
કારણોથી	for reasons
પેનલ્ટીમાંથી	from penalties
કરનારાઓને	To those who
શામ	Sham
કેબલમાં	In cable
તસવીરનું	of the picture
ગુલ્લી	Gulli
વિમાનમાં	On the plane
અટવાયા	Atwaya
ખાસિયત	Features
માવઠામાં	In Mawtha
બ્યુટિફૂલ	Beautiful
મનભરીને	Mindfully
સુંદર	Pretty
વેચવા	To sell
શર્મજનક	Embarrassing
જોષી	Joshi
સાઇના	Saina
હોળી	Holi
શોષણના	of exploitation
દીકરાને	son
બાયોપિકનું	of the biopic
લાલચે	Greed
હરામ	Haram
ફ્લિપકાર્ટને	To Flipkart
આલિયાના	Alia's
10500ની	10500
જાફિરાનો	Jafirano
પંજાબનાં	Of Punjab
હવામાં	In the air
મેળવ્યો	Received
રેલવે	Railways
ફરમાવતી	
સમાચારઃ	News:
બાળકીઓની	of the girls
ધનુષ	Sagittarius
600ને	To 600
ગુલઝાર	Gulzar
નાશ	destroyed
599માં	In 599
ઇનામ	Prize
પાનકાર્ડ	PAN Card
મર્ડોકે	Murdoke
રાખેલા	Kept
રૂપિયામાં	In rupees
2015ના	Of 2015
લોકપ્રિય	popular
શકાશે	Can be
નોકરાણીનો	of the maid
એમ્બે	Ambe
ધંધાર્થીઓને	To businessmen
કરતી	doing
ક્લબમાં	at the club
4થી	From 4
સારુ	Good
આંગળી	finger
મેળવે	Gets
નુકસાન	Damage
મુદ્દોઃજેટલી	Issue: As much as
ડ્રગ્સનાં	of drugs
સબરીમાલા	Sabarimala
7નો	of 7
સ્તનપાન	Breastfeeding
સીઇઓ	CEO
સુપરફાસ્ટ	Superfast
યુવતીને	to the girl
પ્રભુએ	The Lord
લીઝા	Lisa
જયપુર	Jaipur
50પૈસાના	50 paise
રાવલ	Rawal
હવાઈ	Hawaii
લક્ષ્મી	Lakshmi
ઈશાનાં	Ishaana
શરન	Sharan
ઉદિતા	Udita
સિંગતેલના	Singtel's
ફેબ્રુઆરીએ	In February
કરવાનો	to do
અરબપતિ	billionaire
તપાસમાં	In the investigation
વેલ્યૂ	Value
વેચાતી	Selling
કરચોરીની	of tax evasion
બ્રધર્સઃ	Brothers:
મારી	mine
લંડન	London
બોક્સમાંથી	From the box
તુટ્યો	Broken
જીયોના	Giona
વિવાદનો	of dispute
માત્ર	only
રેપરના	of the rapper
ચૂક્યુ	Chukyu
બ્રહ્માસ્ત્ર	Brahmastra
ઓગષ્ટમાં	in August
સુમિત	Sumit
શોખ	Hobby
કેટલું	How much
પુછી	Asking
સરનનાં	Saran's
તેટલી	As much as
લાવો	Fetch
ઓળખ	Identity
લોકાર્પણ	Launch
ફેરફાર	change
વેટીંગ	Waiting
કર્લી	Curly
અબજ	Billions
અંકોથી	from digits
રાયને	Ryan
જોઇન્ટ	Joint
10380ની	Of 10380
વરરાજાનો	of the groom
ખિસ્સાને	to the pocket
છોકરી	The girl
યૂપીના	Of UP
સ્ક્રીનગાર્ડ	Screenguard
મધુર	sweet
દેશોની	Countries
લેવા	To take
દેશો	Countries
રાખેલી	Kept
તન્નાએ	Tanna
છુપાવીને	By hiding
ઘાયલ	injured
ટ્રાય	Try
10115ની	Of 10115
ખુશ	joyful
અઠવાડિયે	Weekly
લકી	Lucky
ભારતની	Of India
ચાર્જશીટ	Chargesheet
અજાણ્યા	Unknown
આપનારાઓનો	of the givers
વિદાય	Farewell
વિશ્વની	of the world
એકાઉન્ટ	Accounts
સલમાનની	Salman's
ટુંકો	Short
છમ્મા	Chhamma
ત્રિશાલાએ	Trishala
એડમિનની	admin's
ખરીદશો	Buy
જમ્યા	Ate
1000નું	Of 1000
શૉથી	From The Show
સેવાનો	of the service
મજબૂત	firm
લગ્નના	of marriage
વીત્યું	passed
અમલમાં	In implementation
ઘસવાનાં	To rub
વેલકમ	Welcome
નોકરીના	Of the job
અઠવાડીયાથી	from week
જોખમ	Risk
કૈફના	Kaif's
ડ્રગ્સ	Drugs
તબ્બુ	Tabu
મહત્વના	Important
પુછશે	will ask
લોટરી	Lottery
વેનિટી	Vanity
બુકમાં	In the book
સરી	Sari
દબંગ	Dabang
સમસ્યાથી	from the problem
રાજમોતી	Rajamoti
ઠાકોરનો	Thakor's
ઇમરાન	Imran
ખાનગી	Private
બેંગ્લુરુની	Of Bengaluru
ખરીદો	Buy
આંકડાને	To the figures
શાહરૂખનો	Shah Rukh's
ભુલથી	by mistake
આપવાની	to give
મોકલાવેલ	Moknel
લખી	Writing
હોલમાં	in the hall
ડાયલોગના	Dialogna
દફનાવવામાં	To be buried
ફૂડપાર્કને	To the foodpark
બાળકીની	of the girl
માયા	Maya
કેપ્ટન	Captain
ખરીદે	Buys
ડાયન	Diane
રોકાણકારો	Investors
સાંભળ્યું	Heard
પીવડાવીને	By drinking
પડ્યો	fell
વિલયઃ	Vilaya:
સ્માર્ટફોનને	to the smartphone
ઉલ્ટા	Upside down
અવરામને	To Avram
અજીબો	Strange
છોકરીઓને	To the girls
નાણાની	of finance
ક્રિષ્નાની	Krishna's
હટીને	By removing
માત	Maat
મહેમાનોનું	of guests
સરપ્રાઇઝ	Surprise
સ્નોમેપ	Snowmap
બન્ને	Both
કમાનારી	Earner
વ્હીલર	Wheeler
કોર્પોરેશનનો	of the corporation
રાધિકા	Radhika
ફેઈલ	Failed
શ્વેતા	Shweta
ફડચામાં	in the phadcha
ઓપરેટ	Operate
વાઈરલ	Viral
ભગવાન	God
અવનવા	Avanwa
બીજો	Another
નેક	Neck
બોલ્ડ	Bold
ચુપ્પી	Chuppi
નિકને	To Nick
ઘુસ	Entry
લિયોની	Leoni
બેંકોનાં	of the banks
બેકરીનો	Of the bakery
મચાવી	Raasi
તમામના	of all
બેશરમ	Shameless
સર્વે	Survey
દીકરા	Son
જોડાયેલુંઃપીએમ	Connected to:PM
તીન	Teen
બાળકે	Child
ઉદ્દેશ	Purpose
નોકરીઓના	Of jobs
જેક્લિને	Jacqueline
અમદાવાદ	Ahmedabad
ગીતા	Gita
રેખાએ	On the line
ફેક્ટરી	Factory
કાઢ્યું	Removed
આજથી	From today
દેખાડી	Shown
વધુની	More
મેસેન્જર	Messenger
હેલનનાં	Helen's
ગેરન્ટેડ	Guaranteed
રમી	Played
નિર્ણયને	Decision
રામદેવ	Ramdev
વાળી	Folded
બાઈક્સ	Bikes
રણબીરનો	Ranbir's
શહેરોની	of cities
સુસ્મિતા	Sushmita
અંત	End
બદલામાં	In return
કપૂરના	Kapoor's
શમીની	Shamini
વધારાના	Extra
ડરેલા	Scared
મારીશું	We'll kill
થતા	happening
રકમ	amount
જાહેરાતોને	To ads
નિર્ભર	Dependent
ફરજિયાત	Compulsory
ચાર્ટર્ડ	Chartered
ગોરખપુર	Gorakhpur
ઐશ્વર્યાને	To Aishwarya
પોલિસ્ટર	Polyester
લહેરાવી	Waving
પ્રતિબિંબ	Reflections
જોયેલી	Viewed
ગાવા	To Sing
ગગડ્યો	Messed up
હલકી	light
ડ્રગ્સની	of drugs
સૈફને	To Saif
પરની	On
ખતરો	Danger
ઘટાડો	Decrease
નેટવર્ક	Network
જયેન	Jayen
ધ	The
સર્જાશે	will be created
ક્વાર્ટરમાં	quarterly
યુવતીએ12	The girl12
ઇશ્યુ	Issue
આઇટમ	Item
પ્રેગ્નેટ	Pregnette
બાળકોની	Children's
ડિક્રુઝ	D'Cruz
બન્યો	became
ટેરિફથી	from tariff
બાળક	child
વરરાજાએ	The groom
રામપાલ	Rampal
ઓબામા	Obama
ત્રિમાસિક	Quarterly
ટ્વિટર	Twitter
નાગરિક્તા	Citizenship
ફોનના	of the phone
ફિલ્મનુ	of the film
કપડાંથી	from clothes
હરણફાળઃ	Haranfal:
ક્રાઇમ	Crime
ડબલ	Double
સહગલ	Sahgal
વધારાથી	Additionally
બદલાયુ	Changed
સ્પેશ	Space
બચી	Surviving
જરુરી	Necessary
બહેનપણી	Sisterhood
બ્રેસ્ટ	Brest
ઈસ્કોન	ISKCON
શોલ્ડર	Shoulder
બજેટ	Budget
બુકિંગ	Booking
મોઘવારીનો	Moghwari's
ચર્ચા	Discussion
ભાડું	Rent
જોખમઃ	Risk:
આયુષ્માને	To Ayushman
ગણેશ	Ganesh
સાઈન	Sign
ફાળકે	Phalke
અંગદ	Angad
મોકો	Chance
બેઝિક	Basic
થશેઃ	It will be:
જોડાશે	Will join
મોદીને	Modi
આધારકાર્ડને	Aadhaar card
દીકરીના	of the daughter
સિંગરે	Singer
દિલને	to the heart
ભરાઈ	Filled up
વિલન	Villain
કૌશલે	Kaushal
રાજકોટમાં	In Rajkot
અવારનવાર	Frequently
છેતરી	Cheating
કંપની	company
વ્યક્તિના	person's
અપાવશે	will give
કડાકોઃ	Kadako:
પહોંચશે	will arrive
વર્ષનાં	of years
નાણામંત્રી	Finance Minister
મુંગડા	Mungda
ટ્રોલર્સે	Trollers
બેથી	From two
ઈરફાન	Irfan
કાંડ	Scandal
વસ્ત્રોમાં	In clothes
શ્રદ્ધાની	of faith
ખુશી	Happiness
બેંકો	Banks
સરખો	Same
વિરૂષ્કાના	Virushkana
સરકારમાં	In Government
બોલીને	By speaking
રોકાય	Stayed
નાખીશું	We'll put it
રમત	Game
કરવા	to
મોર્ગન	Morgan
વાઇબ્રન્ટમાં	In Vibrant
ટ્યૂબ	Tube
લઈને	Take
નિર્ણયો	Decisions
20સુધી	Up to 20
કન્ટેસ્ટંટનાં	Of the contestants
વોલેટમાં	In the wallet
ઝટકા	Jhatka
મિનિટમાં	in minutes
બોયફ્રેન્ડ	boyfriend
કોમ્પ્યુટર	Computer
નીકાળ્યો	Ejected
દેવે	God
હેરી	Harry
મોહાપાત્રાને	To Mohapatra
શાંતિ	peace
વોટ્સએપના	Of WhatsApp
1000ની	Of 1000
કામણ	Kaman
અડધાથી	Half
જાવેદ	Javed
ખાતુ	Accounts
પ્લેટ	Plate
ડાઇલોગ્સથી	From Dialogs
નિવાસે	Residence
વધ્યાં	increased
ફિલ્મફેરની	Of Filmfare
ટેન્ટ	Tent
ઉતરણ	Landing
બચાવનારા	Rescuers
પસાર	Passing
રેપનાં	Repna
સવારે	In the morning
રનૌટનાં	Ranaut's
ભૂમિપૂજન	Bhoomi pujan
શ્રી	Shri
નોટનો	Notes
ઉપજ	Yield
સોરી	Sorry
જંત્રીના	Jantri's
લુંટાયા	Lootaya
ઇન્કમટેક્સમાં	In income tax
કલાકનો	Hours
યાદ	Remember
ભરાઇ	Filled up
ભ્રષ્ટાચાર	corruption
લઉ	Lou
સોનમના	Sonam's
ડેરીએ	Derrie
બીનો	Bino
કરિશ્મા	Karishma
કબુલ્યું	admitted
251માં	In 251
એપ્સથી	from apps
ઇમેજ	Image
પેડમેન	Padman
કાર્પેટ	Carpet
અપનાવો	Adopt
સ્માર્ટફોનના	of the smartphone
બહેનોને	To the sisters
ફિલ્મી	Filmy
ડેસ્કટૉપથી	From desktop
હડતાળઃ	Strike:
ઘેરાયેલી	besieged
સીનમાં	In the scene
લાંબો	Long
સ્ટીંગ	Sting
બતાવ્યો	Shown
કમાન્ડર	Commander
એનર્જી	Energy
ટીવીના	TV's
સાજીદ	Sajid
વર્ષનો	year
સમ્રાટે	The Emperor
70હજાર	70,000
અડશે	will touch
આધાર	Support
બત્તી	lamp
લાગેલો	felt
બટાટા	Potatoes
જીયોથી	From Jio
ચોક્સીએ	Choksi
10નો	of 10
વાયરલ	Viral
સુરતઃ8	Surat: 8
પુન	Again
એપ્પલે	Apple
13માં	13th
ટાળ્યો	Avoided
દયાભાભીનું	Dayabhabhi's
મો	Mo
જોગવાઇ	Provision
ખત્મ	End
વાંધો	Objection
ત્રિમાસીકમાં	in the quarter
કાંડે	On the shoulder
ઓફર્સથી	From offers
પૂરું	Complete
ઊંઘી	Sleep
ભડક્યો	provoked
સેટેલાઇટ	Satellite
ઉતારો	Take off
મુગ્ધ	Mugdha
શિક્ષકોનો	of teachers
દુબઇમાં	In Dubai
સિમ્પલ	Simple
સ્માર્ટફોનનું	of the smartphone
અફવા	Rumors
બગડ્યું	spoiled
અમેરિકામાં	In the United States
બેબ	Babe
રૂપિયાની	Rupees
સાળાની	Brother-in-law
પોર્ટલ	Portal
લાઈફમાં	in life
પ્રદર્શનની	of the exhibition
પ્રતિકૃતિ	Replication
ટિકિટ	Tickets
ટેલેન્ટ	Talent
ખાટલા	cot
ડાન્સરના	of the dancer
બેનામી	Anonymous
લડાકૂ	Fighters
શાહી	Ink
સિમ્બાનો	Simbano
રિહાના	Rihanna
હદ્દ	Haddd
મુરાદ	Murad
અરબાઝનું	Of Arbaaz
ડિઝલનો	of diesel
શ્રીદેવીના	Of Sridevi
સુનીતા	Sunita
બુલેટની	of the bullet
ઘેરાયેલો	Surrounded
વીડિયોને	Video
મેટલના	of metal
ધણું	Money
સુવિધાઓ	Features
બદલવા	To change
મેક્સિકોનાં	Of Mexico
કલેક્શન	Collection
સુપરહિટ	Superhit
કંપનીના	Company's
સ્ક્રિનને	To the screen
લાયસન્સની	License
બમ્પ	Bump
અપ્સરાને	To Apsara
બચાવ્યો	Rescued
સાક્ષીના	Of a witness
ધમાલનો	Of the storm
ક્રિકેટના	of cricket
વહૂ	Wohu
ગ્લેમરસ	Glamorous
જૂહી	Juhi
આવકાર્યુંઃ	Welcomed:
આઘાત	Shock
ચાહકોને	To the fans
મોબાઇલનું	of mobile
પિત્તો	Pitto
વેટરે	Vetter
કરિનાનાં	Kareena's
નકારાત્મક	Negative
જીન્સ	Jeans
બેક્ફી	Becfi
ડિઝલને	To Diesel
ડ્રીમ	Dream
બધા	All
રોજનાં	Daily
દુબઈ	Dubai
શ્રેષ્ઠ	Best
મલાઇકાનો	Malaika's
સુઝુકી	Suzuki
ઓફરને	To the offer
હારી	Losing
હીના	Heena
એપિસોડની	of the episode
થઇ	happened
ડોલરનું	dollar
પાણીનું	of water
સ્ટારની	of the star
ચેનલે	Channel
નાણાં	Money
દુરુપયોગ	Abuse
કપાયેલું	Cut off
ચોગ્ગા	fours
સાવંત	Sawant
પતંજલિના	Of Patanjali
કમાવા	To earn
સૈનિકોની	of the soldiers
સ્પર્ધકનો	of the contestant
પોલિસી	Policy
ચોરોએ	Thieves
લડાઇ	Fighting
માટે	for
આદતને	habit
ફોટામાં	In photos
સેન્ટર	Center
ટેક્સથી	from taxes
સિદ્ધુ	Sidhu
રજિસ્ટ્રેશન	Registration
જોવો	Watch
હે	Hey
પરસેવો	sweat
નાંખીને	by pouring
આનંદની	of joy
ઘણાં	Too many
યુવાધન	Youth
વાંચતા	Reading
રહે	stay
અંદાજમાં	In estimates
મસ્તીભર્યો	Fun-filled
ચુકવવા	To pay
સીઝનની	of the season
હાર્ટ	Heart
ઓઢીને	Odhine
ઉડી	Flying
કર્મચારીઓમાં	among employees
ગ્રેટ	Great
કમાણીનું	Earnings
જીદ	Stubbornness
હુમલાનો	of the attack
અંજિની	Anjini
બનાવતું	Creating
પાદુકોણ	Padukone
2ને	2
આજ	today
10425ની	10425
વિશ્વાસ	Trust
રસ્તે	On the way
દક્ષિણ	South
ન્યૂમોનિયા	pneumonia
મજબુત	Strong
રૂપિયાનાં	of rupees
ચેકબુક	Chequebook
અર્પિતા	Arpita
વાજપેયીએ	Vajpayee
મોદીકેર	Modicare
દરના	Rate of
પર્સનલી	Personally
મારશો	Kill
લિંબુથી	From Limbu
ઓટોમોબાઇલ	Automobile
લેવાનું	To take
સોફ્ટ	Soft
જપ્ત	Seized
સ્વિટ્ઝરલેન્ડની	Of Switzerland
ડિઝિટલ	Digital
જંગ	Jung
ગ્રૃપ	Group
વઘારશે	Will
ભરવો	Fill in
તેમાંથી	Of them
6ઓગસ્ટે	On August 6
બેંકોના	of the banks
ફૂટ	Foot
શું	What
પદ	Post
પોઇન્ટનો	Point of
લાલચ	Greed
ફી	Fees
પુરૂષ	Men
ગમી	Liked
ફ્રાન્સમાં	In France
ટ્વીટ	Tweet
ચાહક	Fan
કલાકે	hour
બગાડ્યો	spoiled
પરિસ્થિતિ	condition
યોજાશે	Will be held
ગંદી	Dirty
કેપ	Cape
જો	If
ભીંડ	Bhind
આઈફોન	iPhone
ભાગીદારી	partnership
શમ્મી	Shammi
ફડણવીસ	Fadnavis
પાત્ર	Character
પરિણીતિએ	Married
વેડફે	Wedde
લાખની	lakh
પરિવારના	family
શિકારમાં	In hunting
ગુમાવી	Lost
બેન્કોએ	Banks
દૂધ	milk
થતો	happening
અરોરાએ	Aurora
સરખામણીમાં	in comparison
ચૂકી	Missed
જમાવડો	Deposit
જજની	Judge's
છતાં	Yet
લપડાક	Lapdak
લગાવે	Apply
એશિયાનો	of Asia
કરોડપતિ	Millionaire
અનોખો	Unique
સુખ	Happiness
સુરવીને	Surveen
કાગડો’	Crows'
માગી	Asked for
છૂટની	Exemption
રુપિયાનું	of rupees
સસ્તમાં	Cheaply
નાખશે	will cast
સિનેમાની	of cinema
ઈન્કમ	Income
તાલથી	From the rhythm
જિલ્લાના	District
ગુલઝારની	Gulzar's
સૂચના	Notification
ફાર્મહાઉસના	Of the farmhouse
કિમત	Price
બચાવવાના	To save
કેટલાએ	How many
એવું	So
બફાટ	Buffet
અદિતી	Aditi
વડવાઓના	of the vandals
એન્ટીગુઆને	To Antiguan
પાણી	Water
લખેલું	Written
રિઅલ	Real
લોન્ચિંગની	of the launch
વેશ્યાવૃત્તિમાં	In prostitution
વોલેટ્સ	Wallets
સીનનાં	Of The Scene
ચોથું	Fourth
ભૂલીને	Forgetting
મહત્ત્વની	Important
અતરની	Atarni
ડિમાંડને	to demand
સિઝન	Season
1લાખનો	1 lakh
શરતથી	Conditionally
ગેંગવોરની	Of gangwar
કેરળમાં	In Kerala
સતામણીનો	harassment
અખ્તરનાં	Akhtar's
સપાટીને	to the surface
1400થી	From 1400
10720ની	Of 10720
તાપમાન	temperature
ચાર્લી	Charlie
હસ્તીઓએ	Celebrities
મીડિયાકેસ	MediaCase
હાજરી	attendance
આગોતરા	Advance
નેમ	Name
ઈર્ષ્યા	Jealousy
જાતે	On its own
અલ્પેશ	Alpesh
કતારો	Qataro
ચિદમ્બરમે	Chidambaram
ઈન્ફ્રાસ્ટ્રક્ચર	Infrastructure
એક્સપ્રેસ	Express
છૂટશે	will be released
સિન્હાનું	Sinha's
ત્રણ	Three
ઈન્ડસ્ટ્રીઝે	Industries
લીસ્ટ	List
ડ્રામાની	of drama
ટેબલેટ	Tablet
રબર	Rubber
ભીડમાં	In the crowd
સંન્યાસ	Sannyasa
પટેલની	Patel's
યુવકો	Youth
ઇશાનને	Ishaan
પૌત્રી	granddaughter
વ્યક્તિનો	of the person
સાંસદ	MP
28મો	28th
સંન્યાસી	Sanyasi
બ્રુના	Bruna
આકાશે	In the sky
ખન્નાને	Khanna
સુહાનાને	To Suhana
સોનાલીએ	Sonali
મોબાઇલનો	of mobile
વચગાળાનાં	Interim
ડિસ્પલે	Display
ડૉલર	Dollar
સલમાનના	Salman's
યૂઝર્સના	of the users
દિવ્યાંકાએ	Divyanka
ડેડલાઈન	Deadlines
990માં	In 990
બ્લેકમની	Blackmoney
વાગશે	will ring
ભરાતી	Filling up
લેવી	Levy
મેચો	Matches
હકીકત	fact
વિકલ્પ	Option
નિયંત્રિત	controlled
પ્રયાસ	Try
બ્રાંચ	Branch
અસિત	Asit
મોંઘા	Expensive
ઉગાડે	Grows
આરોપમાં	in charge
પ્લીઝ	Please
જોડીઓએ	Pairs
જગ્યાએથી	from place to place
બાથટબમાં	In the bathtub
લાવો”	Bring it"
એલ્સીસ	Alsis
દગાબાજ	Fraudster
આટલા	So much
ગુજરાતમાં	In Gujarat
કુટેવ	Kutev
ડેરી	Dairy
કાર્યવાહીની	of the proceedings
ઓપેકે	OPEC
ગેજેટ્સ	Gadgets
જન્મદાતા	The birth-giver
ફ્રિઝ	fridge
મોદીનો	Modi's
વાપરાશ	Usage
ફેસ્ટિવલમાં	At the festival
બીયર	Beer
હર	Har
સ્ક્રિન્જ	Skritz
મારતા	Hitting
જજો	Judge
આખરમાં	Finally, at the end
રણવીરનાં	Ranveer's
નોટે	Notte
ઊધડો	Wake up
શકશો	Will be able to
સમર	Summer
અભિનેત્રીની	Of the actress
શતાબ્દીમાં	in the century
વાળાની	Of vala
ઑપ્શન	Option
રોબોર્ટે	Roborte
દલેર	Daler
શીલાનો	Sheila's
હોપ	Hope
દાંડેકર	Dandekar
વિકમાં	In The Week
ધંધા	Business
સદનમાં	In the House
નાણાકીય	financial
ખોલાવો	Open
બિલ	Bill
એકલો	Alone
પાણીની	water
કહી	say
પાડ્યું	dropped
એમ	M
સોંપાયો	Assigned
મોતના	of death
વિશે	About
અલવિદા	Goodbye
બાઇકમાં	In the bike
રૂપાલી	Rupali
સ્કીમમાં	In the scheme
કપિલે	Kapil
દેવી	Devi
ચાંદીમાં	In silver
ઉત્પાદન	Production
રઘુરામ	Raghuram
3નું	of 3
શીખવાડવા	To teach
કરોડનાં	crores of
તેંડુલકરની	Tendulkar's
કન્ટેસ્ટન્ટે	Contestant
સૈફની	Saif's
ઑસ્કાર	Oscar
નવાઝુદ્દીનની	Nawazuddin Siddiqui
રાકેશ	Rakesh
મની	Money
આપનાં	Yours
પુનરાગમન	Comeback
કર	duty
કદાચ	Perhaps
ફાઈલ	File
કરિઅર	Career
હીરોઇનને	to the heroine
યોજનાથી	From the plan
ડૂડલ	Doodle
રેટમાં	in rate
લવબર્ડ્સ	Lovebirds
રેપના	Repna
ડિરેક્ટર	Director
મુક્યો	placed
51ગામો	51Villages
પાસ	Pass
હાશ્મીના	Hashmina
શકી	could
બાળપણમાં	In childhood
લોગો	Logo
ભારે	heavy
પિતાએ	Father
ઘણા	Many
પુણે	Pune
અન્યને	to others
વસ્તુઓ	Items
કબૂતરબાજી	Pigeons
ખુશખબર	Good news
સેલેરી	Celery
ગાબડું	the mess
માણસ	man
ક્યા	Where
પંચમાં	In punch
સ્વેગ	Swag
તેમા	In that
સિંઘનો	Singh's
નિવૃત્તિ	Retirement
નેપકીન	Napkins
હડતાળ	Strike
ડ્યૂટીને	to duty
લોકોનાં	people
પહેરતા	Wearing
સ્કૂલના	School
ખોલ્યું	Opened
હંગામો	ruckus
કબુલાત	Confession
વધુનો	More
સુવર્ણકારોએ	The goldsmiths
ઉદ્યોગમાં	In the industry
ચાલુ	Ongoing
સુરતઃ	Surat:
સીધો	Straight
દેશી	Desi
એવોર્ડ્સ	Awards
મેગાપિક્સ	Megapixels
સ્કૂટરના	of the scooter
બેન્ડ્સઃ	Bands:
તાકતા	Takata
મિઝવાન	Mizwan
ઠાકરેએ	Thackeray
એન્ટીગુઆમાં	In Antigua
અદ્રશ્ય	Invisible
સ્પાઈડી’ને	To Spidey'
સ્વિમસૂટમાં	In a swimsuit
દીકરાનાં	of the son
બેઝોસ	Bezos
સ્પામ	Spam
આને	To this
ફરહાનની	Farhan's
સાંભળે	Listen
ચિકની	Chikni
આવવા	To come
બોલાવી	Called
જાન્યુઆરીએ	In January
ફોટોશૂટે	In photo shoot
સોશિયલ	Social
ત્યારે	Then
પ્રકારની	Kind of
દાયકા	decade
અટલ	Atal
વીમા	Insurance
રૌતેલાનાં	Rautela's
ફ્લાઇટથી	By flight
હતાઃનીતિન	Were: Nitin
એકટીવ	Active
પ્રિક્વલ	Prequel
ઘડિયાળ	clock
મહેતાને	Mehta
કરોગી	Karogi
વિકેન્ડ	Weekend
રિહાન	Rehan
મફત	Free of charge
કોમ્પેક્ટ	Compact
રાજસ્થાનથી	From Rajasthan
આખુ	The whole
આગ	Fire
જનતાએ	The public
બોડીમાં	in the body
લુકા	Luca
સ્પીડ’માં	In speed'
સર્જરી	Surgery
દિમાગની	of the mind
અંબાણીએ	Ambani
હરકત	Harkat
પ્રોડક્ટ્સ	Products
પંપ	Pump
રાખનારાને	To the keeper
ટ્રંપને	Trump
કરાશેઃ	Will do:
સંભાળશે	Will handle
એકટ્રેસ	Actress
કમલ	Kamal
જોડાયેલા	Connected
વિદેશીઓ	Foreigners
રિઆલિટી	Reality
પીડિતની	of the victim
વરૂણે	Varuna
આગામી	Next
જોડકી	Pairing
ડાયને	Diane
લગાવતી	Applying
મિનિટ	minute
કોડ	Code
જબ	Jab
સૂરજ	Sun
ફ્લિપકાર્ટના	Flipkart's
રુપિયાની	of rupees
શાઓમીએ	Xiaomi
હોત	would have
નિશાના	Nishana
ગંભીર	Serious
કિંમતોમાં	In Prices
રોકસ્ટાર	Rockstar
રોયસ	Royce
મે	May
ખૂબસૂરત	Beautiful
કાને	Kane
ડોગ	Dog
રહ્યા	Stayed on
ટિઝર	Teaser
અમદાવાદી	Ahmedabadi
ચોરીના	Theft
મિલાવ્યા	Mixed up
સંપત્તિમાં	in property
મારફતે	through
આશાઓ	Hopes
માસ્ટરબેશન	Masterbation
ફેન	Fan
ટોટલ	Total
બેટરી	Battery
એકાઉન્ટથી	from the account
જાણતુ	Know
કરનારાઓ	Doers
બોલીવૂડ	Bollywood
જૂનાગઢ	Junagadh
ચૌધરી	Chaudhary
ખતરાથી	from danger
યોજના	Plan
હજારો	Thousands
ફોનનાં	of the phone
કારણે	Due to
ઇલેકટ્રિક	Electric
મહિનાામાં	in months
પેન્સીલ	Pencil
1નો	of 1
થાઈલેન્ડથી	From Thailand
રામદેવની	Ramdev's
જૂન	June
સોનૂ	Sonu
મહત્વની	Important
મિસ્ત્રીએ	Mistry
ગૌતમ	Gautam
રાજપૂત	Rajputs
આવું’	That's it."
જ્વેલરી	Jewellery
હોવા	To be
ઠગાઈનું	cheating
મ્યુચ્યુઅલ	Mutual
તૈયારીમાં	In preparation
ઓર્ગેઝમ	Orgasm
ખર્ચે	At the cost
લકીચાર્મ	Luckycharm
તહેવારોમાં	During festivals
શોપ	Shop
મલિક	Malik
સુઇ	Sui
ઈન્સ્ટાગ્રામ	Instagram
રાજકોટના	Of Rajkot
બોટ	Bot
માં	In the
બિકીની	Bikini
સ્ટેટમેન્ટ	Statement
છું	I am
મહત્વનું	Important
એક્ટ્રેસિસે	Actresses
લૂંટી	Robbed
ચલાવીને	By running
સેલેબની	Celebni
ગોરી	Blonde
સંસ્કારી	Cultured
જનરેટ	Generated
સભામાં	At the meeting
4દિવસમાં	In 4 days
પોલીસની	Police
ફોર્ટિસ	Fortis
કિમ	Kim
નવા	New
ભોસલેએ	Bhosale
ફૂલેકું	Phulekun
રોજગાર	Employment
રુહીનો	Ruhino
સારાએ	Sara
કર્ણાટકના	Karnataka
શરીરમાં	in the body
હિસાબ	Accounting
ભી	Wet
ક્લાસ	Class
જગતમાં	in the world
અભિયાન	Campaign
ક્રમે	In order
જ્હાન્વીએ	Janhvi
આહુજા	Ahuja
દિલ	heart
શર્મિંદા	Sharminda
એક્શન	Action
જણાવશે	will tell
ગર્લફ્રેન્ડનું	Of girlfriend
જકડતો	jolting
ટામેટા	Tomatoes
સ્ટાર્સે	Stars
તમે	you
સ્ટ્રોક	Stroke
તાળી	Clap
કારીગરી	Workmanship
મહેતાના	Mehta's
અનેકવાર	Many times
વધારાઇ	Additional
પિયા”પર	Pia" on
તેની	his
યંત્ર	Machine
થયોને	happened
સ્લેબ	Slab
ઇન્ટરનેશનલ	International
બદલા	Change
ચાદ	Chad
ટાઇટલ	Title
સેક્ટરમાં	in sector
બોનસ	Bonus
રાદડિયાની	Radadiya's
છત	roof
કરિઅરનો	Career's
વૃદ્ધિદરનો	of growth rate
જોડાઈ	Connected
કાર્ડધારકો	Cardholders
ફેનની	Fan's
જરૂરીઃ	Required:
સગાઈ	Engagement
પાંદડા	Leaves
આત્મહત્યાનો	of suicide
મીકા	Mika
હીરો	diamond
સાચું	correct
કઠુઆ	Kathua
રહસ્યનો	Of the mystery
ક્વાર્ટરનું	of the quarter
આંખ	eye
ટીના	Tina
બિનિતા	Binita
સીનથી	from the scene
ભાવોથી	by prices
1માં	In 1
ચલકાતી	Moving
છોડીશ	Will leave
વિભાગ	Section
તપાસ	Investigation
ઉપાડે	Upage
લઇશ	I'll take it
ફોનનું	of the phone
સેલિબ્રિટી	Celebrity
એડમાં	In Ed
સીનિયર	Senior
ડાયેટ	Diet
ડ્યૂટી	Duty
વખાણઃનોટબંધીથી	Praise: From notebandi
46ની	Of 46
વ્રત	Vrat
ચાલતુ	Running
કોમેડીથી	From comedy
જિઝૈલ	Jizel
2019નાં	Of 2019
કરેલા	Done
વેઇટ્રેસનું	of the waitress
ઘઇ	Ghai
બિપાશાએ	Bipasha
ચુકી	Missed
બરોડાની	Of Baroda
રોણા	Rona
અમીષા	Ameesha
કડવાશ	Bitterness
કમાઈ	earning
માણો	Enjoy
દરરોજ	Every day
મોબાઇલનુ	of mobile
દાદા	Grandfather
વોરિયરે	Warrior
સ્પૉટ	Spot
સ્થળ	place
રડી	Crying
ખાવાનું	Eating
બેન્કોમાં	in banks
રોહમન	Rohman
ખડખડાટ	rattle
સુષ્મિતા	Sushmita
પાસવર્ડની	Password
કટ	Cut
પતિએ	husband
રીલિઝના	of release
પરિવારે	Family
રૂપમાં	in form
હોમ	Home
મુસીબત	Trouble
શો	Show
સરખામણી	Comparison
દેખાવા	To appear
કોને	To whom
કથિત	Alleged
જોડામાં	In pairs
બેંકકૌભાંડી	Bank fraud
રિપેરીંગ	Repairing
કરાવ્યા	done
તેરી	Yours
સપ્ટેમ્બરમાં	In September
પૂતળું	Statue
કેમરાની	Cameron's
હી	He
મેરી	Mary
લગાવ્યો	applied
સિકંદર	Sikandar
જઈ	Go on
નૂતને	Nutan
દે	De
દેવસેનાને	To Devasena
મોના	Mona
હસ્તીઓ	Celebrities
શર્માની	Sharma's
એટેક	Attack
રમઝટ	Ramzat
ફાયદા	Benefits
યાદીમાં	In the list
ઇએમઆઇ	EMI
બેવડાયા	doubled
માઇક્રોમેક્સનો	Micromax's
વકરો	The boy
જેહાદને	Jehad
ફોટોશૂટની	of a photoshoot
ચૌધરીને	To Chaudhary
40વર્ષ	40 years
ટેટાની	Tetani
નજરથી	by sight
મેળવ્યા	Received
ભારતીય	Indian
માચિસની	Of Matchis
મેહંદી	Mehndi
સ્માઈલ	Smile
અંતરિક્ષમાં	in space
રોકેટના	of the rocket
એપ્સ	Apps
ડેટા	Data
શર્ટ	shirt
માહિર	Mahir
નોટોનું	of notes
ગાયક	Singer
બાયડના	Byadna
શનિવારની	Saturday's
વધારી	Increased
મારે	I have
કરિનાને	To Kareena
રજુ	Present
કૌશિકે	Kaushik
સિદ્ધુની	Of Sidhu
ગિફ્ટની	of the gift
અંકુશ	Control
ગ્રુપ	Group
અદાઓનો	of the adas
જન્નત	Jannat
અભિનેતાએ	Actor
જડબાતોડ	Jaws
જીમિતે	Jimite
માથું	head
3થી	From 3
શર્માને	To Sharma
નજરઅંદાજ	Ignored
વેરિએન્ટ	Variant
શિખર	peak
નાનાની	Small
અક્ટુબર	October
મેહર	Mehr
રવિવાર	Sunday
ઇચ્છતી	Wanting to
ભયાવહ	Terrible
કાશ્મીરમાં	In Kashmir
અન્વેષીએ	Anweshi
આવતારમાં	in the coming
મોરબીઃ2012ના	Morbi: Of 2012
ટ્રાવેલ	Travel
રેકેટ	Racket
ક્રોધે	anger
અનોખું	Unique
કૉલ	Call
આમા	In this
રસ	Interest
રાખડીઓ	Rakhis
સંખ્યા	number
બેંકનો	of the bank
સસરાનું	Of father-in-law
હોટનેસનાં	Of hotness
તારે	Yours
અબુ	Abu
ખુલાસોઃ	Explanation:
પાર્ટ	Part
વાતનો	Talk about
શિંદેએ	Shinde
કલાકના	hours
મુર્હૂતના	Murhutana
કસ્ટમર્સ	Customers
મીણબત્તી	candle
કોકટેલ	Cocktails
અનોખા	Unique
નબળો	Weak
કમાયા	earned
સમાએ	Samae
અદાઓથી	From the adas
માથામાં	in the head
સક્સેસ	Success
સમેટવા	To wrap up
વધાવ્યો	Increased
દુઃખી	Sad
10480ના	10480
સુવાના	Suwana
અટક્યું	Stopped
જાણવા	To know
રીતરિવાજથી	By ritual
રાગિની	Ragini
રહ્યો	stayed
જશો	Go
દત્તની	Dutt's
સબસિડી	Subsidy
યોજનામાં	In the plan
મિત્રોનો	of friends
આવતાં	coming
અરોરા	Aurora
સામેલ	Involved
ગેંગરેપનાં	of gang rape
પેઢીની	of the generation
છૂ	Chhu
બરતરફ	Dismissed
બમ્પર	Bumper
પિંક	Pink
કાયદાકીય	Legal
પગલા	Steps
આરોપોથી	from the allegations
રહેશો	Will stay
જલઈલે	Jalile
મરણોત્તર	Posthumously
રામણ	Raman
રાઇઝિંગ	Rising
જવાથી	By leaving
કઝાકિસ્તાનની	of Kazakhstan
આસામ	Assam
ઘટીને	decreasing
કાપડ	Cloth
કિંમતના	Of Value
ઉતારચઢાવ	Ups and downs
બનાસ	Banas
બંધાયુ	Bandayu
સ્કૂલમાં	At school
ઇન્ટરનેટ	Internet
પહેલુ	The first
વારણસીની	Varanasi
પડવાની	to fall
રોજનો	Daily
બોલિવૂડનાં	Of Bollywood
ઘટાડતાં	decreasing
જાહ્નવી	Jahnavi
હીરાના	Hirana
દઇશ	Daish
પટૌદી	Pataudi
શેરોમાં	in shares
ક્રોસ	Cross
નોકર	servant
પ્રાથમિક	Primary
મદદથી	With help
ચેટીંગ	Chatting
ડોક્યુમેન્ટ	Document
સુધારાના	Of improvement
31માર્ચ	March 31
મિનિમમ	Minimum
માનવું	believe
મેના	Mena
યાર્ડની	yard
વાતોથી	From talk
ભોજપુરીની	Bhojpuri
અહીંથી	From here
યાત્રીઓ	Passengers
નિફ્ટીમાં	In The Nifty
હરાજીનો	Of auction
ટોલટેકસ	Toltecs
પેંશન	Pension
શંખનાદ	Shankhnaad
ફિલ્મની	of the film
આર્યન	Aryan
ડેવલપમેન્ટ	Development
રેપો	Repo
ઑફરનો	of the offer
સંશોધન	Research
ખોલતા	Opening
999માં	In 999
આંખોમાં	in the eyes
ટવીસ્ટના	Twistana
કરીએ	Let's do
મસ્ત	Fun
સમિટમાં	at the summit
રપિયા	Rappia
મને	Me
લેવડ	Transactions
આયરલેન્ડ	Ireland
પીરસ્યું	Served
લગ્નગ્રંથીએ	On the wedding
પતંજલિ	Patanjali
કપાવ્યા	cut off
ગ્રામીણમાં	in rural
મોકલ્યું	Sent
મેગેઝિન	Magazine
ટ્વિંકલે	Twinkle
બળાત્કાર	rape
પરિણીતિનું	of the bride
ફ્રેશ	Fresh
ડેટાનો	Data
સ્પ્લિટ્સવિલા	Splitsvilla
શ્રીને	To Mr.
પોતાનાથી	by itself
ભરમાર	Filled up
ઉંમરની	of age
શરતોઆધીન	subject to conditions
નવું	New
વેડિંગ’માં	In 'Wedding'
મળ્યા	Met
દાદાસાહેબ	Dadasaheb
ચોખા	Rice
ભરશે	Will fill
એપ્લિકેશનથી	From the app
નીકળશે	will leave
ફાયદામાં	Benefits
ભારતીયએ	The Indian
દેશના	of the country
સંગિત	Associated
એક્ટ્રેસનો	of the actress
પગલે	Following
ટેસ્ટ	Test
અદા	Ada
કોનવર	Konwar
વલણ	Trend
ગરીબીમાં	in poverty
અલીબાગ	Alibag
મહેન્દ્ર	Mahendra
વૉટ્સએપ	WhatsApp
મશીન	Machine
વાયરલેસ	Wireless
પરંપરામાં	In tradition
કરીને	by
ડિઝાઈન	Design
કલાકાર	Artist
પંપે	Pumpe
ઇશીમા	Ishima
પીએફના	OF PF
લેતા	Taking
ટોયલેટમાં	In the toilet
નિરવ	Silent
જુનું	Old
નિફટી	Nifty
નું	of
ચીનને	To China
રમતમાં	In the game
અર્જુનનાં	Of Arjuna
વારસી	Warsi
ટાઇમમાં	in time
સ્ટાર્સ	Stars
કાગળમાંથી	From the paper
એકથી	from one
છુપી	Hidden
સૌનું	of all
કમાઇ	Earn
મોદીના	Modi's
દિલધડક	Heartbreaking
ખોલવાનો	Opening
બાકી	Remaining
મહેબુબ	Mehboob
રૂમાલ	handkerchief
બોની	Bonnie
ખાનદાનનો	Of the family
ફસાયાના	Trapped
બેલ્સ	Bells
શાંત	calm
શેટ્ટી	Shetty
હેકરે	Hacker
વર્ષથી	from year
ભીડ	Crowd
સીરીઝ	Series
તૂટશે	will break
ભર	Fill in
આખુવર્ષ	Throughout the year
સારા	Good
ચારથી	From four
નારાજ	Angry
કરાશે	will be
કારણ	cause
1800નું	Of 1800
ધડાકો	Explosions
ફોનની	of the phone
ભડકો	Flare-ups
ટ્રેનની	of the train
સોનમ	Sonam
ઉછાળા	Boom
ટ્રેડલિંક	Tradelink
ડૂબ્યું	Drowned
મૈત્રી	Friendship
તેમની	theirs
આપ્યો	Given
અમેઝોન	Amazon
તિલક	Tilak
વેસ્ટ	West
સ્પીડનો	of speed
ભાગવતને	Bhagavata
જિયોના	Giona
પીન	PIN
ઇન્શ્યોરન્સની	Of Insurance
કિલોમીટર	Kilometers
સત્યમેવ	Satyamev
મુંડન	Mundan
બિશ્નોઇ	Bishnoi
સજાવાયું	Punished
ડિઝાઈનર	Designer
મિટિંગમાં	At the meeting
માર્ચે	In March
સાસુને	To mother-in-law
ક્લીનશેવ	Cleanshave
ડબ્બે	Dabbe
પધાર્યા	Arrived
હોસ્પિટલમાં	in the hospital
મનીની	Money
કિલોના	of kilos
અદાજ	Adaj
મલ્હોત્રાની	Malhotra's
નથવાણી	Nathwani
કામે	At work
સસ્તો	Cheap
સવાલના	Of the question
ફસાઇ	Trapped
દાવેદાર	Claimant
ગોળી	Bullet
ખરીદતા	Buying
યૂઝર્સને	To the users
કપાતની	of deduction
સાવધાન	attentive
સીમાની	Border
બ્યૂટિએ	Buttie
ઈન્ડીગોએ	IndiGo
કસ્ટમાઇઝ	Customized
મેક્સિમ	Maxim
કાઢ્યા	Removed
જમાઇ	Son-in-law
ગણાવ્યા	Counted
સર્જરીનો	of surgery
રોકીને	To Rocky
યુઝર્સે	Users
શપથ	Oath of office
મજૂરોને	To the workers
ઘૃણા	Hate
ગાડીઓને	To cars
ઉજવ્યો	Celebrated
ડેટિંગ	Dating
ઝૈનની	Zayn's
છુપાવનારી	Concealer
કલર	Color
આલોકનાથે	Aloknath
મિલિંદ	Milind
પૂજાથી	From worship
જાળવી	Maintained
ઇશિમા	Ishima
કોમર્શિયલ	Commercial
રાખો	Keep
ન્યૂયોર્કની	Of New York
પાર્ટને	Partne
ભરાવવા	To fill
સુંદરતા	Beauty
ઝઘડા	Fights
સાચા	True
એપ્લાય	Apply
આયર્ન	Iron
શહેરોમાં	in cities
ખર્ચાશે	will be spent
ભાણેજનો	Nephews
બીકિની	Beckini
મહિનામાં	in a month
સિદ્ધાર્થના	Siddhartha's
પાર્કમાં	in the park
સંજૂની	Sanjuni
ડરાવનાર	Intimidator
વોલેટનો	Wallet's
પોસ્ટ	Post
દમદાર	Strong
ઉંદર	mouse
ઉઠાવી	Picked up
શોના	Show
જેટ	Jet
અણસાર	Ansar
ધવનની	Dhawan's
સિંગરની	Singer's
ભણતી	Studying
કલંક	Stigma
દેખાતી	Visible
માગતી	Ask for
ભરપૂર	Plentiful
ઓસ્કાર	Oscars
પેનડ્રાઇવમાં	In pen drive
મળીશું	We'll meet
કાઢ્યાના	Removed
અલંકૃતા	Alankrita
ઘટાડવા	To reduce
જાહેરમાં	In public
એક્ટરે	The actor
ચલાવવાનો	Running
આપેલા	Given
ગબ્બર	Gabbar
ટિકાકારો	Critics
તૈયારીઓની	Of preparations
નિવીઆનો	Niviano
પાંચથી	from five
સેકન્ડ્સમાં	in seconds
હની	Honey
મીડિયામાં	In the media
સંપત્તિનો	of the property
યૂરો	Euro
હુમા	Huma
સેલિબ્રેશન	Celebration
અભિનેત્રીનો	of the actress
કેવું	How about
એકટિંગ	Acting
સાથ	With
ડાયાબિટીસ	Diabetes
નપુંસક	Impotent
સીનને	To Sean
દંડમાં	in fine
બોઇંગ	Boeing
બ્રેજા	Brezza
હાઇકોર્ટ	High Court
એટલાં	That's all
સાથેઉજવ્યો	Celebrated with
જોય	Joey
મજુરનો	of the worker
આટા	Flour
યોજનાનો	Scheme
યોગ્ય	appropriate
ખર્ચી	Spent
મળ્યો	Found
શિવાની	Shivani
પરંતુ	But
દેવાયું	given
ભાઇ	Brother
મુક્કો	Punches
સ્વીમશૂટમાં	In a swimsuit
ડૉક્યુમેન્ટ	Document
આર્થિક	Economic
ગૃહિણીઓને	Housewives
તોડ્યા	Broken
8000થી	From 8000
ગ્લોબલસ્કિન	Globalskin
હેઇન્ઝ	Heinz
હાથ	hand
ડ્યુટી	Duty
બચાવ	Rescue
સંપતીની	of property
વીજળીનું	of electricity
યુદ્ધનો	of war
ભાવોમાં	in prices
દિલદાર	Dildar
વેકેશન	Vacation
મિર્ઝાની	Mirza's
સાઉથના	Of the South
570માં	In 570
બેકઅપ	Backup
નાઇટીઝને	To the Knights
ઉજવણી	celebration
રાખશે	Will keep
બૉય	Boy
વિકસિત	Developed
ગુરૂવારથી	From Thursday
સેક્ટર્સમાં	In sectors
ઘાઇ	Ghai
તાનાજી	Tanaji
રોયનું	Roy's
કેવા	How
વસાવવા	To settle
વેચવામાં	In selling
કાળું	black
ઇન્ડિયાની	Of India
કરંસી	currency
મળ્યુ	Found
કરાવતાં	Getting it done
જ્યોર્જિયા	Georgia
ઉદ્યોગ	Industry
એનિવર્સરી	Anniversary
ટ્રેનમાં	On the train
કૌભાંડ	Scam
ઠગાઇ	cheated
આકારનો	Shaped
ચેન્જ	Change
શિવ	Shiva
યૂઝર	User
કંઈક	Something
મોઘા	Mogha
બ્રાઇડિયલ	Bridial
મહેતા	Mehta
બેડશીટ	Bedsheet
કાર્તિ	Karti
જાન	Jan
લોકેટ	Locket
જુરાસિક	Jurassic
અપલોડ	Upload
પહેલી	First
મેએ	May
પરથી	From
અબ્બાસે	Abbas
ઝીરો	Zero
ઇશ્કબાઝ	Ishqbaaaz
પ્રમોશનમાં	In promotion
શ્લોકા	Shloka
પડદો	Curtains
કેમ્પની	Campney
પહેલેથી	Already
જીજૂ	Jiju
નિભાવ્યો	Executed
વેચાણ	Sales
બ્લેકમેઇલ	Blackmail
કોલિંગ	Calling
14મી	14th
લચીલી	Flexible
ઢબે	In style
ગૂણ	Gun
સાણંદમાં	In Sanand
ભાવથી	by price
ફોટોશૂટમાં	In a photoshoot
કરું	I'll do it
આલોક	Alok
આજનો	Today's
ફ્રેન્ચાઇઝી	Franchisee
વેન્યૂ	Venue
કમાય	earn
કાઢ્યો	Removed
રોશનીથી	From Roshni
સાયનાની	Saina's
કંપનીઓના	companies
જાસુસી	Spying
હસ્તક્ષેપ	Intervention
કમાવવાનો	Earning
પ્રાર્થના	Prayer
આટલી	So much
આંચકો	shock
બક્ષી	Bakshi
જોવાનો	To watch
વેપારનો	of business
મુંબઇની	Of Mumbai
પડે	falls
નિર્ણય	Decision
નામુ	Namu
ઐશ્વર્યાનો	Of Aishwarya
હાર્દિક	Hardik
સ્પેશિયલ	Special
મળતુ	Found
શરૂઆતી	Startup
પ્યારી	Dear
બિગબોસની	Bigg Boss
બનાવવાનો	To create
પ્રત્યક્ષ	Real
એરલાઇન	Airline
બંધુઓએ	Brothers
રીતો	Ways
આંગણી	courtyard
વિશ્વમાં	in the world
કારજ	Karaj
બાહુબલીના	Of Baahubali
એકટ્રેસના	Of actresses
પરિણિતી	Parineeti
ફેસ્ટિવલ	Festival
ખુલે	Opens
ગ્રીસની	Of Greece
શેર્સ	Shares
સોપો	Soupo
પૈસામાં	in money
સ્પટેમ્બરથી	From September
રિપોર્ટર	Reporter
આદેશથી	By command
આરબીઆઇનું	of the RBI
ફરવા	To roam
કર્મચારીઓ	Employees
ઝાયડસ	Zydus
રામાયણ	Ramayana
કરીના	Kareena
સર્વિસ	Service
લંડનથી	From London
સાચીઃ	True:
અભિષેકની	Abhishek's
મંત્રાલયે	Ministry
એલ	L
મહિનાથી	months
લોકોના	people
ડ્રાઈવિંગ	Driving
મિલેગી	Milegi
પ્રથમવાર	For the first time
સભાસદોનુ	of the members of the assembly
ડ્રેસમાં	In dress
કોર્ટને	To the Court
પ્રેમજીને	To Premji
પાત્રમાં	in character
કામધેનું	Kamdheno
પ્રેરણા	Inspiration
સ્વાસ્થ્યમાં	in health
હાઈ	High
મોદી	Modi
સુસ્મિતાએ	Sushmita
હલવા	Halwa
બદલવાનું	Changing
બતાવાયું	Shown
ખાતાધારકોએ	account holders
મિત્રોએ	Friends
30વર્ષ	30 years
કંટાળીને	tired
ફ્રીડમ	Freedom
હસ્તગત	Acquired
ચુકવવો	Pay
હટાવી	Removed
એક્સિડેન્ટ	Accident
બેનિફિટ	Benefits
જાણ	Information
ઘડિયાળે	On the clock
સોનામાં	In gold
પુછ્યું	Asked
કંગનાના	Kangana's
યુવતીઓએ	Girls
નવેમ્બર	November
રેસમાં	In the race
30નો	Of 30
ક્રૉસ	Cross
પ્રિમીયમ	Premium
માઈક્રો	Micro
ટ્વિટથી	From the tweet
ધર્મ	religion
ફ્રાંસથી	From France
વોલમાર્ટે	Walmart
પહોંચેલા	arrived
ઈલેક્ટ્રીક	Electric
સંપત્તિની	of the property
રોમાંચક	Thrilling
પાઠવ્યા	Sent
રિગિંગ	Rigging
મોનેટાઇજેશનના	of monetization
બ્યુટી	Beauty
અય્યારી	Aiyaary
750નો	Of 750
જણાવીને	By telling
એન્જિનથી	From the engine
ચોખાથી	From rice
વર્તમાન	Current
વ્યારાના	Vyarana
ફઝલની	Fazal's
સહયોગ	Collaboration
મહેન્દ્રસિંહ	Mahendra Singh
કરાવવું	To do
વાતને	Talk about
પાંજરે	Cage
આભાસ	Abhas
બધાને	All of them
મૂંઝવતા	confused
હેલ્પ	Help
રેટ	Rate
યૂનિવર્સની	of the universe
ધ્રૂમપાન	Dhrumpana
500નાં	Of 500
કાસ્ટિંગ	Casting
સાજિદ	Sajid
શાહરૂખનું	Shah Rukh's
સુપરસ્ટાર	Superstar
ગલીમાં	In the street
દિવસ	day
સૌથી	The most
હજી	Still
કોર્યોગ્રાફર	Choreographer
પાકિસ્તાનની	Of Pakistan
ફેસ્ટિવ	Festive
હોવી	To be
પશ્ચિમ	West
સાંભળવા	To listen
500ની	Of 500
મેઘધનુષ	Rainbow
મોકલેલા	Sent
ન્યૂઝને	To the News
ઉછાળાની	Booming
ગૂગલ	Google
શ્રદ્ધા	Faith
ખેતરમાંથી	From the farm
નાખ્યા	dropped
10590ની	Of 10590
ઉભા	Stand up
નિયમ	rule
નોકિયાનો	Nokia's
ચૂપ	Silent
હત્યાનાં	of murder
નખશિખ	Nakhsikh
શેકે	Sheke
100ટકા	100 percent
એક્સ	X
મસ્તમૌલા	Mastmaula
મન્નત	Mannat
બચ્ચનની	Bachchan's
બેંકઃ	Bank:
ખાસ	Special
દીપક	lamp
ધમધમશે	Will be banging
ટુંક	Short
આવકવેરા	Income Tax
પાણીમાં	in water
હંમેશા	Always
માણી	Enjoy
120નો	Of 120
ખરીદાશે	Will be purchased
26મીથી	From 26th
લાખમાં	in lakhs
અહેવાલ	Report
વોશરૂમમાં	In the washroom
આરે	Aarey
મારો	mine
વેલિડિટી	Validity
સ્વિપરની	Of the sweeper
જલવો	Burn
શાહિદે	Shahid
સેલિબ્રિટીઝની	Of celebrities
રોલ્સ	Rolls
ઇન્ટિમેટ	Intimate
સેલ’	Cell'
ચાંદીની	of silver
મુંબઇવાસીનો	Of Mumbaikars
4જી	4G
વાયદા	Futures
લાગતો	It seemed
ગૅસ	Gas
મધ્યમવર્ગ	Middle class
જઈશ”	I'll go."
અહીંયા	Here
ભાષામાં	in language
ભોગવે	suffering
સોમવાર	Monday
અંતમાં	At the end
સ્માર્ટફોન્સ	Smartphones
મેડિકલ	Medical
જેમની	whose
વોશિંગ	Washing
પેડનેકર	Pednekar
માઈલેજ	Mileage
ભૂલ્યો	Forgotten
સંબોધન	Address
સેક્શન	Section
માઇકલ	Michael
તાત્કાલિક	Immediate
જીત્યો	Won
મેટરનિટી	Maternity
ઠાલવી	Thalovi
મહેંદીની	Mehndi's
માર્ચના	March
ઝવેરીઓનું	of the jewelers
ટ્રાઇ	TRAI
જતો	going
કર્યુ	done
દળોને	to the forces
હટાવાયો	Removed
સેનગુપ્તા	Sengupta
પ્રકારનો	Type of
મખના’	Makhna'
મુન્નાભાઇમાંથી	From Munnabhai
આક્રોશ	Anger
તૈમૂરની	Taimur's
ડાકૂ	Daku
ફટાફટ	Quickly
ગાયબ	Missing
બિસ્તર	Bistar
ગેમના	Of the game
લાંબી	Long
વિદેશી	Foreigners
બદલાણી	Change
નોટબંધી	Demonetisation
રોયલ	Royal
મહિલાઓના	Women's
થયા	happened
પીઠ	Back
મેળવો	Get
રિલાયન્સે	Reliance
કયા	Of what
ઝફર	Zaffar
છોકરાને	to the boy
વગરનું	Without
સસ્પેન્સ	Suspense
કરવાનું	to do
સલમાને	Salman
સ્તર	Level
સિંગાપોરમાં	in Singapore
સિંગરને	To the singer
જુના	Old
સિન્સ	Sins
સ્ટુડિયોની	Of the studio
કાજોલનો	Kajol's
અલી	Ali
સ્ટાર્સની	of the stars
જોહરા	Zohra
કાંચી	Kanchi
સુધારો	Update
ટાળીને	Avoiding
ઇલેક્ટ્રિક	Electric
મેમ્બર	Member
પહોંચ્યો	arrived
અન્યનાં	of others
ભાઇજાન	Bhaijaan
નાણું	Money
સેલરીમાં	In Celery
ફીચર	Feature
લ્યો	Leo
મેચ	Match
દીધો	given
મૂકીને	put on
બિયોન્સેના	Beyoncéna
ફેરમાં	in fair
મિર્ઝા	Mirza
કટોકટી	Emergency
જવાશે	will go
દુનિયાનું	of the world
કોર્ટરૂમમાં	in the courtroom
મેળવવા	To get
મુંબઈની	Of Mumbai
279માં	In 279
વિચારણા	Consideration
ખરીદનાર	Buyer
દુનિયાને	to the world
ડીલ્સ	Deals
દીધા	given
હનીસિંહ	Honey Singh
પ્રભાસનો	Of Prabhas
બજારમાં	In the market
અનેક	Many
10400ની	Of 10400
આદર્શ	Ideal
કર્મચારીઓનો	employees
સામાન	baggage
આયેગા	Aayega
પ્રીતિએ	Preeti
જ્વેલર્સમાં	In Jewellers
ધૂપિયા	Dhupia
બસમાં	On the bus
ખરીદવા	To buy
કાર્ડથી	from the card
બી	seed
ફેસેલિટી	Facility
મેસેજ	Message
ડિનર	Dinner
બાઈકની	of the bike
હેંક	Hank
માંગ્યુ	Asked for
34ની	Of 34
ખાન	Khan
કરાયુ	Karayu
પૂર્વ	East
અંબાણીની	Ambani's
જવાનોની	jawans
સ્વિસ	Swiss
સરકાર	government
વેબસાઈટો	Websites
સેવન	Consumption
કૈફ	Kaif
છોગાડા	Chogada
સોમન	Soman
ઉત્ક્રાંતિમાં	In Evolution
રિ	Ri
જૈનની	Jain's
ભણતા	Studying
લગ્નમંડપમાં	At the wedding hall
જેટલીને	To Jaitley
કૃપા	Please
કોડથી	from the code
આપવાં	To give
વિથ	with
કેન્સરગ્રસ્ત	Cancerous
અંબાણીને	To Ambani
એરલાઈન	Airline
ધરખમ	Strong
વર્ચ્યુઅલ	Virtual
લિબાસમાં	in Libas
બાલ	Baal
પુત્રની	of the son
ફિલ્મથી	from the film
પગાર	pay
આવકવેરાની	Income Tax
સર્જરીએ	by surgery
વધઘટની	Fluctuations
જંગલી	Wild
ગોલ્ડન	Golden
અજયની	Ajay's
દિવસભર	Throughout the day
રાજની	Rajni
લગ્નની	Of marriage
શૅફ	Chef
ભત્રીજી	niece
ઈન્ડિગો	IndiGo
માતાનાં	Mother's
પંડ્યા	Pandya
છોકરાએ	The boy
પત્ર	letter
સદગુરૂ	Sadhguru
તનુશ્રી	Tanushree
બેડરૂમમાં	in the bedroom
સંગીતને	To music
વીરે	Veere
ફટકારી	hit
સાથેનાં	With
વગાડતા	Playing
ટેકનોલોજીમાં	In technology
440માં	In 440
માર	Beating
ટેક્સટાઇલ	Textiles
બંગડીઓ	Bangles
ડૉક્ટરની	Doctor's
સ્કીમનો	of the scheme
નકારી	Rejected
ચાલનારા	Walkers
180થી	From 180
પસંદ	Selection
ઉદયપુરમાં	in Udaipur
સાચવો	Save
ડાંસ	Dance
વિંતા	Vinta
વિલ	Will
જવાં	To go
અનુરાગની	Anurag's
નોકરીઓનો	of jobs
પુછવા	To ask
ચીજની	of the thing
પ્રયાસો	Efforts
લોન્ચઃજોવો	Launch: Watch
લિસ્ટમાં	On the list
અગ્રવાલ	Agarwal
રેસ્ટોરન્ટમાં	In the restaurant
અનુષ્કાનું	Of Anushka
એક્ટર	Actor
ટૂમોરો	Tomorrow
ફિક્સ્ડ	Fixed
અદાકારને	to the actor
રાજી	Raji
લીધેલી	Taken by
તાહિરા	Tahira
ઘટાડાના	of reduction
બદલ્યા	Changed
શાહરુખને	To Shah Rukh
ગભરામણ	Panic
એકલા	Alone
અંગ્રેજીની	Of English
બંન્નેને	Both of them
ભાવી	Bhavi
બીગ	Big
ઇક્વિટી	Equity
અકસ્માત	Accident
મહેશ	Mahesh
100કરોડની	Rs 100 crore
એકસાઈઝ	Excise
2000માં	In 2000
ધારકોને	To the holders
રણવીરસિંહ	Ranveer Singh
રહેશેઃ	Will be:
શાહરુખ	Shah Rukh
હાશ્મી	Hashmi
મોહાબતે	Mohabbatein
કાયમી	Permanent
અસમનો	Of Assam
હૂબહૂ	Whooever
ક્ષેત્રે	In the field
સાત	Seven
શ્રદ્ધાનો	of faith
હિરોઈનોનો	Heroines
આરબીઆઇએ	RBI
રોજની	Daily
નેવી	Navy
હચમચી	shaken up
ચેલેન્જ	Challenge
ગેરન્ટી	Guarantee
સંભાળ્યો	Handled
મુહૂર્ત	Muhurat
108નો	Of 108
વેબસિરીઝે	Webseries
જા	Go
એલી	Ellie
નીકના	Nickna
પંજાબી	Punjabi
વિદેશ	Abroad
દિવસથી	From day on
મૂળના	Original
ઉજવશે	Will celebrate
જરૂર	Needed
પ્રેગ્નેન્ટ	Pregnant
માનહાનિનો	of defamation
લીના	Lina
કડાકાની	Kadakani
કાબૂમાં	Under control
વાતચીત	conversation
ક્લાસિક	Classic
પદ્ધતિઓથી	by methods
સેટેલાઈટ	Satellite
ટુ	To
કેનેડાની	of Canada
સંપત્તિ	Property
ચાલી	Running
આટલ	So much so
રોષે	Anger
હોટનેસની	of hotness
ઘટાડાથી	from the decrease
આતંકવાદને	Terrorism
પાસપોર્ટ	Passport
ઠગ્સ	Thugs
બદલ્યો	Changed
ધુમ	Smoke
મનમાં	in mind
જ્યોતિર્લિંગના	Jyotirlinga
એન્જિનિયરિંગ	Engineering
ગૂમ	Gum
કવિતાઓ	Poems
3799નો	Of 3799
ધર્મેન્દ્ર	Dharmendra
અંદાજ	Estimates
પગલું	Step by step
મારીને	killed
અર્ટિગા	Ertiga
હોલિ	Holly
ફેસબુકના	Facebook's
સદભાવ	Goodwill
ચુકાદો	Verdict
મેમ્બરશિપનો	of membership
મંત્રીનું	Minister's
શિવગામીની	Sivagami's
આદત	Habit
પાંડેનું	Pandey's
થિયેટર્સ	Theatres
જૂઓ	Juo
ચુકવો	Pay
સમજો	Understand
કફોડી	Kafodi
બદલાવ	Changes
લીવની	Leveni
તારીખો	Dates
રેખાના	of line
હંસિકાની	Hansika's
ડ્રોપથી	From the drop
ખુશબૂ	Fragrance
પરસેપ્શન	Perception
સુપ્રીમ	Supreme Court
મિસ્રમાં	In Egypt
ઓફિસ	Office
લતના	Latna
વિરાટ	Virat
ક્ષણિક	Momentary
જુડવા	Judwaa
ચલણી	Currency
ફટકો	Shock
જીંદાદીલી	Zindadili
વાપરો	Use
ફ્લૉન્ટ	Flant
બીલવ્ડ	Belvd
પીવડાવતી	Drinking
ષડયંત્રનો	of conspiracy
મેન	Man
સેક્રેટરી	Secretary
સાનિયા	Sania
આપ્યા	Given
ફેવરિટ	Favorite
હુસ્ન	Husn
રૂપિયાને	to the rupee
ફિચર્સ	Features
મંગળસૂત્ર	Mangalsutra
ફિનાલેમાં	In the finale
ડાર્ક	Dark
વીકમાં	in the week
પૂણે	Pune
ગિન્ની	Ginny
બનાવતા	Creating
આરબીઆઇના	OF THE RBI
નમક	salt
મંગાવાશે	Will be ordered
વિજેતાનું	of the winner
થીમ	Theme
કાઢવા	To remove
આનંદ	happiness
ફુડ	Food
રૂપિયા	Rupees
ચુક્યા	paid
ટૂકાં	Tukka
હટાવવો	Remove
દુનિયાનાં	of the world
પરિવારનાં	of the family
અજિત	Ajit
પહેર્યું	Worn
જંગલમાં	in the forest
લતાએ	Lata
મહાસેલ	Mahasell
એવરગ્રીન	Evergreen
સ્ટારે	Starre
ખાતાં	Accounts
પડશો	Fall
પ્રોડક્ટ્સને	Products
ખત	Khat
ચોરાય	Thieves
પૉઇન્ટ	Point
લગ્નનાં	Of marriage
સંગ	Song
કપૂરનાં	Kapoor's
સિક્સ	Six
નીલુનું	Of Neelu
50થી	From 50
જવેલર્સોની	Of jewelers
મી	m
સીએમ	CM
બિલકુલ	Absolutely
લાલુના	Lalu's
ફ્લેક્સી	Flexi
વસુલે	Vasule
જવાનો	To go
જમાવટ	Deployment
મલ્હારનો	Malhar's
નૂતન	Nutan
નારાયણમૂર્તિ	Narayanamurthy
ટેક્નોલોજીની	of technology
11ની	of 11
ઇન્દોરમાં	in Indore
નૉમિનીને	To The Nominee
કાજોલની	Kajol's
ભોસલેના	Bhosalena
નેનો	Nano
ભૂલ	Error
કુમારે	Kumar
વેલિડ	Valid
પેન્ટ	pants
સુપરફ્લોપ	Superflop
શૂટ	Shoot
પોસ્ટરમાં	In the poster
ખાત	Khat
અલીબાબા	Alibaba
અભિનેત્રીઓનો	of actresses
મળતા	Meet
વિચલીત	Scattered
કેરીનો	Kerry's
અમિત	Amit
વ્યવસ્થા	Arrangement
મૂડીઝે	Moody's
પવન	wind
ખેડૂતોને	Farmers
કાર	car
દુકાનની	shop
ગવર્નર	Governor
છુપાઇને	By hiding
29મી	29th
કેન્સર	Cancer
દિયા	Dia
પ્રપોઝલ	Proposal
થોડા	A few
જૈકલીને	To Jackley
બાપ્પા	Bappa
પ્રત્યેનો	to
મંદીનો	of recession
ડેડ	Dead
મનાવી	To celebrate
100થી	From 100
પૉપ	Pop
ખૂલશે	Will open
ચાર્જિંગ	Charging
આંટીને	Auntie
પત્ની	Wife
ઇન	In
મચ્છર	gnat
કોઈએ	Someone
સહકાર	Cooperation
મોડલનો	of the model
બંધને	To off
ઉરી	Uri
ક્રિતિ	Kriti
ચાર્મ	Charm
ચુકતા	Chukta
હોવાં	Being
રાજકીય	Political
ભસિનની	Bhasin's
મેગાસેલ	Megasale
પ્રિન્સની	The Prince's
સંપતિ	Property
ખાધેલું	Eaten
આતુરતાથી	Eagerly
ફેન્સની	of the fans
પાડી	Down
સફરજન	apple
દેવાળું	Bankrupt
ઘટના	Event
મિડલ	Middle
પરફેક્ટ	Perfect
નાનકડો	Small
માલદિવ્સમાં	In the Maldives
ટ્યુબ	Tube
લઘુતમ	lowest
શરુ	Start
અમલી	Enforcement
ફસાયો	Trapped
સમિટઃગુજરાતી	Summit: Gujarati
મેનેજર	Manager
જામ્યો	Jamyo
આશંકા	Apprehensions
ગ્રૈંડ	Grand
સુરતમાં	In Surat
છુપાવ્યો	Hidden
અમેરિકાનો	Of The United States
બેન્દ્રેને	Bendre
ફેસબુકમાં	In Facebook
સુઝુકીની	Suzuki's
મીસ	Miss
દ્રશ્ય	Scene
કસ્ટમરને	to the customer
ડિસ્પ્લે	Display
ઘડક	the clock
સંગીત	music
000નો	Of 000
નં	No.
નશાની	intoxication
પ્રેરણાએ	Inspiration
આક્રમક	Aggressive
મોબાઈલને	to mobile
પ્રેગ્નન્ટ	Pregnant
ઉભું	Standing up
રંગનાથ	Ranganath
રણદીપ	Randeep
પ્રીમિયમ	Premium
ફન્ને	Fanney
તસવરો	Tasawro
વિભાગના	Department
રામ	Ram
ઇંચ	inches
ઓમકારા	Omkara
હાર	Losing
પૌત્રના	Of the grandson
રિલેશનને	to the relationship
રાખવાની	to keep
રિલેશનશીપ	relationship
હિરાનીએ	Hirani
દુનિયાની	of the world
માર્ગે	Along the way
100ની	Of 100
ઓઇલના	of oil
રિલાયન્સની	Of Reliance
બાળકનું	child's
સ્વરાજને	To Swaraj
ઇસ્લામ	Islam
દુઃખની	of sorrow
રાનીની	Rani's
એચ	H
ડાંસનો	Dance
બેચલર્સ	Bachelors
ચેટિંગનો	Of chatting
ઇચ્છુ	Want to
હોસ્પિટલ	Hospital
9માં	In 9th
લિયોનનું	Of Leon
એન્જેલા	Angela
જ્હાનવી	Jhanvi
રાનીનાં	Rani's
સુષ્મા	Sushma
મારુતિએ	Maruti
સીએમનું	CM's
વર્ષોમાં	over the years
માંગી	Asked for
કામદારોની	of the workers
ગામ	village
સ્વાસ્થ્ય	Health
બાઇકનું	of the bike
ખાતામાં	In the account
સેંસેક્સ	Sensex
રડતાં	Crying
જથ્થો	Quantity
કાર્ડ	Card
રહેવું	dwell
ઓફરનો	of the offer
ભરાશો	Fill up
સગીર	minor
કડાકા	Kadaka
ઓસ્કર	Oscars
૧	1
લગ્નમાં	At the wedding
કિકુએ	Kiku
મનપસંદ	Favorites
હમણાં	Right now
બાલાભાસ્કરનું	Balabhaskar's
અર્થવ્યવસ્થામાં	in the economy
અરબ	Arab
ચાંપી	Champi
યંગ	Young
499માં	In 499
મેસેજની	of the message
2ના	2 of
એપલની	Apple's
કરનાર	Doer
1388માં	In 1388
માહોલમાં	in the atmosphere
રીયૂનિયન	Reunion
કાસ્ટ	Cast
ફંડમાં	in the fund
કહેર	Kahar
ટળી	Avoided
વિંટર	Winter
રખાયા	kept
પસ્તાશો	Repentant
સ્ટેટસ	Status
રિટર્ન	Returns
વર્ષિય	year
આવ્યુ	Came
અમરેલી	Amreli
ઇમરજન્સી	Emergency
કસમના	Kasamana
1649માં	In 1649
રાષ્ટ્રપતિનું	Of the President
પીડિતોની	of the victims
તેવો	Such as
પોસ્ટર	Poster
લગ્નસરામાં	At the wedding
પ્લાનનો	of the plan
ઉદઘાટન	Inauguration
સાથેની	with
બચાવશે	Will save
માતાનો	Mother's
ઐતિહાસિક	historic
ખળભળાટ	commotion
રાજીનામું	resignation
ટ્રોફી	Trophy
લઇ	Take
ઉમટ્યા	Umtya
મોદી’ના	Modi's
નકામુ	useless
ટ્રાન્સફર	Transfer
બેની	Benny
રાજકોષીય	fiscal
આમ	so
લેવડદેવડમાં	in transactions
ક્લિપ્સ	Clips
જેફ	Jeff
ચોકાવનારુ	Shocking
ઓર્ડર	Order
ઑફર્સ	Offers
ગુમાવવા	Losing
દિશાએ	In direction
નહિં	Not
અર્જૂનની	Arjun's
નવેમ્બરમાં	In November
એન્ટ્રી	Entry
મહિનાની	months
મુદ્રા	Posture
ગેરકાયદેસર	Illegal
2020માં	In 2020
રાજેશ	Rajesh
પ્લાનઃ	Plan:
લાવવામાં	In fetching
ગૂગલનો	Of Google
આતંકી	Terrorist
વરિષ્ઠ	Senior
દેવગન	Devgan
આખો	The whole
પેન્ટીને	Panty
ધનવાનોની	of the rich
અંકુશમાં	under control
ખોટુ	False
પારંપરિક	Traditional
મહત્વનાં	Important
સતીશ	Satish
બાજી	Baji
કઢી	curry
અંબાણી	Ambani
બબાલથી	From Babbal
પીરામલનું	Piramal's
શ્રોફે	Shroff
વિના	without
સુદ	Sood
વાઈબ્રન્ટ	Vibrant
ટીવીની	TV's
ઠકરાલ	Thakral
અમરજીત	Amarjeet
ક્યાંય	Somewhere
10માં	In 10
સ્ટેજ	Stage
કેઇલી	Cayley
રાજકારણ	politics
મિત્રો	Friends
અનન્યા	Ananya
જવેલરીનું	Of jewellery
કોલ	Call
સિમ્બા	Simba
મ્યૂઝિકે	Music
અસુર	Asura
ભેટ	Gifts
મગફળીની	peanuts
શહેરનો	of the city
જનમત	Referendum
તસ્કરો	Traffickers
આંખોને	to the eyes
ગૂંજ્યો	Buzzing
એજ્યુકેશન	Education
ડિજીટલ	Digital
બરફમાં	in the snow
સરલ	Saral
કારિગરોને	To The Carigors
વાજપેયી	Vajpayee
રાજને	To Raj
નિર્દેશ	Instructions
બિપાશા	Bipasha
ડોભાલ	Doval
ભારતીયને	To the Indian
સમિટ	Summit
પ્રિન્ટિંગ	Printing
પીવાની	To drink
જીવિત	Alive
રેલવેના	Of the Railways
જલોટાની	Jalotani
કરુ	Do it
મામલે	In the case
વધેલા	increased
5કરોડની	5 crores
ભલભલી	Bhalbhali
દીપિકાને	To Deepika
આકર્ષક	Attractive
માફ	Sorry
ગાય	cow
મેપથી	From the map
સાસુએ	Mother-in-law
ઇન્કમટેક્સ	Income Tax
ભાવૂક	Emotional
ઇન્વેસ્ટર્સ	Investors
કરશો	Do
બીનનાં	Bean's
બધાં	All
સણસણતો	Singsing
બનાવી	Created
12990નો	Of 12990
ભજવશે	Will play
ફૂંકવાની	blowing
રોય	Roy
સિંગર	Singer
અરૂણાચલની	of Arunachal
આવનાર	Coming
સરકારનો	Government
દિલ્હીથી	From Delhi
ઉર્જિત	Urjit
મારા	my
મોબાઈલ	mobile phone
ઈરાન	Iran
ઉમટ્યું	it's over
ઓક્ટોબરમાં	In October
બાળકોના	children's
બોર્ડર	Border
ગાઉનમાં	In a gown
0નું	of 0
બ્લાઈંડ	Blind
લગાવવાથી	By applying
અદભુત	Awesome
આઉટ	Out
જોતી	Watching
આલિયાએ	Alia
એરપોર્ટ	Airport
માલિક	Owner
પૈસાદાર	rich
ભાઇની	brother's
સૂર	Sur
વિશ્વ	world
પત્નીઓ	Wives
દિકરીની	of the daughter
કરેઃસરકાર	Do: The Government
મોતનો	of death
મિર્ઝાપુર	Mirzapur
ચાની	Tea
બેટરીની	of the battery
ટૂરિસ્ટ્સને	To tourists
સ્પા	Spa
નવાઝુદ્દીનનુ	Nawazuddin Siddiqui
ફાઇનલ	Final
રીટા	Rita
કાપી	cut
ખેડુતોને	farmers
પંચમહાભૂતમાં	In Panchamahabhuta
દિશા	direction
ડાયલોગ્સ	Dialogues
વડોદરા	Vadodara
ચાલું	Ongoing
મેટ	Matt
સોફિયાએ	Sophia
આઈલેન્ડ	Island
પ્રાઈવેટ	Private
એન્ટરટેઇનમેન્ટ	Entertainment
ફળ	fruit
વધ્યું	increased
દઈશું	We'll give
અછત	Shortage
કપડાં	clothing
લાયન્સ	Lions
બોલિવુડ	Bollywood
કન્ફોર્મ	Conform
લાઇક્સનો	Of likes
થવાની	to be
ટીવીએ	TVA
કેસરી	lion
પટણીએ	Patni
20વધારી	Increased by 20
સેવામાં	In service
ચોક્સીના	Choksi's
યુટ્યૂબર	YouTube
સાંભળો	Listen
મિલકતોની	of the properties
રેહાએ	Rehae
ઉપયોગી	Useful
સોનું	gold
બસ	That's all
માધુરીએ	Madhuri
પ્રિયાંક	Priyank
શોભશે	Will be adorned
નિર્માતા	Producer
15મીએ	On the 15th
બાલાજીને	To Balaji
વધારોઃજોવો	Increase: Watch
મેમ	Ma'am
અક્ષયને	To Akshay
ત્રિશુલનું	Of Trishul
સ્ટાઇલ	Style
બનેગા	Banega
ડિઝાઇન	Design
ખાન’નું	Of 'Khan'
પ્રતિનિધિ	Representative
એમેઝોનની	Amazon's
એશની	Ashney
હાઉસ	House
કોહલી	Kohli
સ્ટેપ	Step
ફેન્સએ	Fans
ઉઝબેકિસ્તાનમાં	in Uzbekistan
હજારને	to a thousand
ડિપોઝિટના	of deposit
હાલતમાં	in a state
માર્ક	Mark
મળતાં	Meeting
ડરથી	Out of fear
નિર્માતાનો	Producer's
નવ	Nine
કૃષ્ણમૂર્તિ	Krishnamurti
મોબાઈલનો	Mobile's
પાટેકરની	Patekar's
બ્રિટનના	Britain's
હાથથી	By hand
ટૂંકમાં	In short
મર્સિડીઝ	Mercedes
ફસાવ્યો	trapped
સટ્ટાબાજીમાં	In betting
પંચમહાલઃ૧૩૭	Panchmahal: 137
લોકો	people
ઉંધા	blind
રૂપિયાના	Rupees
સ્ટાર્સનો	of the stars
વધતી	Growing up
બકરીને	to the goat
સ્વીકાર	Acceptance
જેલની	of prison
પ્રદૂષણ	Pollution
ઈન્શ્યોરન્સ	Insurance
પીવાથી	By drinking
મૂકી	Put on
ફેન્સને	To the fans
ટેડી	Teddy
ચિપ્સ	Chips
મેમરી	Memory
શિકાર	hunt
200ની	Of 200
ધનિક	Rich
ચાલૂ’	Let's go'
ધનકુબેરની	Dhankuber's
લાઇફમાં	in life
ડોલરની	Dollar
બગાડવામાં	Wasting
સ્પોટ	Spot
રેલ્વે	Railways
સોનાક્ષી	Sonakshi
ખજાનો	Treasures
અસર	Effect
જસ્ટિન	Justin
માલામાલ	Malamal
સમાચાર	news
નાખો	Throw
પરોક્ષ	Indirect
મંથન	Manthan
યુઝર્સની	of the users
બજેટનો	Of the Budget
તુરંત	Immediately
ગર્ભમાં	in the womb
જીવનસાથીના	of a spouse
બ્રાંડ	Brand
ફિલ્માવવામાં	In filming
ઇલેક્ટ્રીક	Electric
કોચર	Kochhar
મુખાગ્નિ	Mukhaagni
નોધણી	Nodhani
કમરમાં	At the waist
લઘુ	Small
બાબતનું	of the matter
ડ્યુટીના	of duty
ન્યાય	Justice
ચોરી	theft
ઉંચકાયુ	raised
30ની	Of 30
ઝળહળી	Glowing
શેર્સમાં	in shares
મહારાણી	The Queen
ગમશે	Would love to
વધુનું	More
નો	No
વપરાશકર્તા	User
વસ્તુના	of the item
મોકલશે	will send
જેલરે	Jailer
પકડ્યો	Caught
અમે	We
ગૂગલે	Google
મુદ્દાઓથી	from issues
બાથરૂમમાં	in the bathroom
કેમેરાવાળો	Cameraman
વોરંટી	Warranty
અનિકા	Anika
બ્રાન્ડ	Brand
ખેડૂતો	Farmers
યોજનાનાં	of the scheme
લહેંગામાં	In a lehenga
લક્ષ્ય	Target
સિરીયલ	Serial
ધનકુબેર	Dhankuber
સ્થિતિ	Status
સોનીએ	Sony
મેગાપિક્સલનો	of megapixels
મદદની	of help
ત્રીજો	The third
ખાંડ	sugar
ગોવા	Goa
તુટવાની	broken
કપિલના	Kapil's
સૂપર	Super
પ્રતિદિવસે	Every day
જેકલીન	Jacqueline
સૂફી	Sufi
રાખડી	Rakhi
બિલ્ડર	Builder
મહિલાઓ	Women
કોર્ટે	Court
વધવાની	To grow
સુમનનું	Suman's
કંગાળ	Poor
બાબૂના	Babuna
કંપનીઓમાં	in companies
રહેલા	Staying
સુપરહીટ	Superhit
સ્પીડવાળો	Speedy
વધુના	More
થર	Thar
સડસડાટ	Sadsdat
આંબેડકરની	Ambedkar's
ફ્રેંડ	Friend
લીનું	Lee's
કિલો	kilo
નિરાશાજનક	Disappointing
ઈન્ટર્ન	Intern
શિખો	Learn
ચડી	Climbed
નાચવા	To dance
35હજાર	35,000
3વર્ષની	3 years old
જ	Only
છોડીતી	Quitting
મલિયાલી	Maliali
ઇન્ડસ્ટ્રીઝના	Of industries
આપેલાં	Given
રોડીઝની	Of Roadies
સગાઇની	Engagement
કહીને	by saying
માસ્ટરબેટ	Masterbet
ચેલેન્જને	To challenge
અાપણી	your
આર્ટિસ્ટે	Artist
બનાવાઇ	Created
બંપર	Bumper
13499નો	Of 13499
કઠોળ	Pulses
છગ્ગા	Sixes
માગને	Demand
કેળા	Bananas
મંજૂરી	Approval
વતન	Hometown
બચ્યા	Survived
ટાયકૂન્સ	The Tycoons
લેનોવો	Lenovo
વોટરડ્રોપ	Waterdrop
આફ્રિકામાં	In Africa
ઓઇલનો	of oil
રેપાપોર્ટ	Repaport
બનાવવા	Creating
પોલીસીના	Of the policy
કાઇલી	Kylie
રનૌત	Ranaut
મ્યૂચ્યુઅલ	Mutual
સિતારાઓનો	of the stars
કનેકશનમાં	In connection
ભાંડીને	Bhandi
શોર્ટ	Short
મોટોરોલાનો	Motorolano
સંરક્ષણ	Defense
ધન	Money
તી	Ti
મોકલ્યા	Sent
શકસો	Could
પ્રસાદને	To Prasad
પ્રમોશન	Promotions
મૅસેજમાં	In message
સિદ્ધી	Accomplishment
સાગર	Sea
દીવાસળી	Diyasli
કોણે	Who
આત્મહત્યા	Suicide
કુમારને	To Kumar
પાથર્યો	Scattered
નવાઝુદ્દીન	Nawazuddin
8ને	8
વળતરથી	from compensation
લાખને	to lakhs
7થી	From 7
શરીફને	To Sharif
ચોપડાને	To Chopra
બંગાળમાં	In Bengal
ચૌધરીનાં	Chaudhary's
જીબી	GB
મહંતે	Mahante
લિપ	Lip
એકની	of one
લોકોમાં	among the people
રમવી	Playing
દિવ્યાંગ	Divyang
અપેક્ષા	Expectations
દેવીને	To the Goddess
ગડબડી	Mess
ગેસની	of gas
ખેમૂ	Khemu
ચૂગલી	Chugli
સંકેત	Hint
હેલી	Haley
રહીશ	Will stay
પટેલ	Patel
હકાલપટ્ટી	Expulsion
કઇક	Something
બનાદી	Banadi
તોડ્યો	Broken
અવોર્ડ્સમાં	At the awards
સોનાક્ષીએ	Sonakshi
વેચ્યો	Sold
શરીર	body
રાજ્યનું	of the state
લગામ	Lagam
કપાશે	will be cut
બિઝનેસથી	From business
એસ્ટન	Aston
શ્રીદેવીની	Of Sridevi
સનસનાટી	Sensation
મશહૂર	Mashhoor
નિયમોનું	Rules
દીકરાના	of the son
એરવેઝે	Airways
રેકોર્ડને	To the record
અપનાવી	Adoption
સ્પિટ્સવીલાની	Spitsvilla's
ઈમરાન	Imran
રજાઓ	Holidays
વળી	And also
કુદકો	Jump
શેટ્ટીએ	Shetty
શોક	Mourning
ચકિત	Shocked
વ્યાજમાં	in interest
સાદી	Simple
મિર્જાપુર	Mirzapur
બ્રિટનવાસીઓએ	Britons
એક્સપોમાં	At the Expo
જિયોને	To Jio
ટ્રિપલ	Triple
કશ્યપે	Kashyap
લાઈનમાં	In line
રાતોથી	overnight
મજબુરીમાં	in majboori
ફ્રેન્ડ	Friend
જગમગી	Jagamgi
ટાટા	Tata
ખોળામાં	in the lap
માતાનું	Mother's
પરણવાં	Getting married
રાજકોટની	Of Rajkot
કલાકમાં	in an hour
શનિવારે	On Saturday
એન્ડ	End
ચોકસીને	Choksi
કમાવવાના	Earning
લેટેસ્ટ	Latest
પરત	Back
ટેક્સ	Taxes
જયતે’	Jayate'
ખન્નાની	Khanna's
મસ્તાની	Mastani
રિંગ	Ring
મંદાના	Mandana
ડુબી	Doobie
જેટલીની	Jaitley's
કાર્યક્રમમાં	At the event
સ્કૂલમાંથી	From school
મોંઘો	Expensive
ફાયદાકારક	Beneficial
ચૌહાણ	Chauhan
પ્રેગ્નેન્સી	Pregnancy
નીચા	Low
જેવી	like
ખાઈને	by eating
શ્રીદેવીનો	Of Sridevi
10420ની	Of 10420
હિડન	Hidden
છોડો	Leave
અબજોના	of billions
ઈન્ડીયાએ	India
વહાવ્યો	Washed away
ઉખાડીને	uprooted
નકામું	useless
સ્પીડમાં	in speed
દેખરેખ	Supervision
બર્થડેમાં	On birthday
સમાધાન	Settlement
તેનું	His
ઓનસ્ક્રિન	Onscreen
નિવદેન	Nivden
વિદેશો	Overseas
મર્જર	Merger
રૂલ	Rule
સુરતઃજવેલર્સ	Surat: Jewellers
બુકમાર્ક	Bookmark
રાધ્યાનો	Radhyano
સનીના	Sunny's
આરામ	relaxation
લૂક્સ	Looks
જતી	going
વિનંતી	Request
ફ્લો	Flow
મંત્ર	mantra
સિકંદરની	Sikander's
ઈન્વેસ્ટર્સ	Investors
ચેજર્સ	Chasers
આપતા	Giving
બાર્ટોલોમીઓ	Bartolomeo
રાખીશું	Will keep
પ્રેગનેટ	Pregnette
માંગ	Demand
વરસાદમાં	In the rain
રોયનો	Roy's
હશે	Would be
શક્તિશાળી	Powerful
તબક્કામાં	In phase
કાનથી	by ear
ગણાવીને	By counting
શૂટિંગનું	of shooting
હૈદરીની	Haiderini
વડોદરાઃ	Vadodara:
રફતાર	Raftaar
કેશબેકની	Cashback
બ્રાંડનો	of the brand
ફર્યા	turned around
નવાઝવામાં	In Nawazwa
ડેડી	Daddy
પદ્ધતિ	Method
છ	Six
વ્યાજની	of interest
સુપરહીરો	Superhero
ફગાવી	Rejected
એજન્સી	Agency
તકલીફ	Trouble
ક્યૂટ	Cute
ઘરના	At home
રોબોટે	Robot
રિક્ષાને	To the rickshaw
બ્રેઝા	Brezza
ખુલીને	Open
બ્લૂએ	Blue
બોલિવૂડનો	Of Bollywood
તાલુકાનું	of the taluka
હવાઈયાત્રા	Air travel
ક્રાંતિ	revolution
અંખિયો	Ankhio
અમીર	Amir
મિઠાઇ	Sweets
મોબાઈલનું	of mobile
પસ્તાવું	repent
સાડી	sari
દિવસનું	of the day
રાજ્યના	State
નજર	Eye
કરન્સીની	of currency
આઇડિયા	Idea
મલાઈકાથી	From Malaika
દીક્ષિતનાં	Dixit's
હેલ્થ	Health
7300ની	Of 7300
વાળા	With
નોંધબંધી	Notebandi
રફ	Rough
બ્રિટને	To Brittany
સપના	Dreams
કેટલા	How many
સવાલોના	of questions
તુષિતને	To Tushit
રાજનની	Rajan's
સિવાય	Except
કરાવવા	To get
પ્રકાશનો	Publications
યૂઝર્સ	Users
આચકો	Shocks
કોર્પોરેશનને	to the Corporation
આતંકીઓએ	terrorists
12વર્ષમાં	In 12 years
નોકિયાએ	Nokia
રશ્કે	Rashke
ટ્રેન	Train
રીકવરી	Recovery
લંગડા	lame
લખનઉમાં	in Lucknow
સાઇકલ	bicycle
મુસાફરીનો	of travel
પોસ્ટપેઈડ	Postpaid
છેડતીના	of molestation
નવેલી	Naveli
રાખવા	To keep
દીપિકાનાં	Deepika's
વિરાટની	Of Virat
મિસ્ત્રી	Mistry
ભાગદોડથી	by running
કિમતમાં	in price
ઇન્ટનેટ	Internet
થિયેટરમાં	in the theater
વીમાની	Insurance
ગાડીઓ	Cars
છૂટક	Loose
ચેટિંગમાં	In chatting
બદલાઇ	Changed
જૂની	Old
અત્યંત	extremely
સિતારાઓ	Stars
ભોજન	meal
મ્યુઝિક	Music
લેવાશે	will be taken
નીકટતા	closeness
કેટેસ્ટંટે	Catestante
ખેંચ્યો	Dragged
સુભાષ	Subhash
વખત	time
સમયે	In time
પોર્ન	
મંદિર	temple
હિન્ટ	Hint
કીંચ	Keynch
લિક	Lick
તમારા	Yours
કૃતિનો	Of the work
સુરતની	Of Surat
જેક્સનની	Jackson's
કાંજીવરમ	Kanjeevaram
વેપારીઓ	Traders
જૂતા	Shoes
હસીનાઓનો	Of the hasinas
તુટ્યા	broken
રેન્કિંગમાં	In ranking
નાનો	Small
કોંગ્રેસ	Congress
300થી	From 300
શાઓમી	Xiaomi
ઈન્ડસ્ટ્રીએ	The industry
ઘડીમાં	In the clock
એનિવર્સરીએ	Anniversary
બૂકિંગ	Bookings
2000થી	Since 2000
ટ્રોલ	Troll
વેઇટર	Waiter
ઘટાડોઃ	Decrease:
વીડિયો	Video
શૅરબજારની	of the stock market
ઉત્સવ	celebration
ફિટનેસનો	of fitness
હિરાજડિત	Hirajdit
સંપત્તી	Property
કપિલની	Kapil's
કાશ્મીરના	Kashmir
દહેગામની	Dahegam's
ફ્લર્ટીંગ	Flirting
પ્રિનાં	Prina
બાયોપિક	Biopic
2ની	Of 2
રિવર્સ	Rivers
તત્કાલ	immediately
સસ્પેન્સથી	from suspense
કેન્દ્રની	Centre
સંમેલન	Conference
જડેલી	Attached
સેક્સુઅલ	Sexual
મહાજને	Mahajan
વાયરસ	Virus
વિચિત્ર	odd
શોખે	Hobby
યૂનિસેફની	Unicef's
અક્ષયની	Akshay's
ઉત્તરાધિકારી	Successor
ચૈપલિનને	To Chaplin
મર્ડર	Murder
લોનથી	by loan
કપાસ	Cotton
હસીનાઓ	Hasinas
બગાડ	Waste
જુલાઇથી	From July
પવિત્રતા	Holiness
સ્મિતા	Smita
સૈફ	Saif
9ના	of 9
નામનો	Name
આંક	Figures
શિવગામી	Sivagami
પ્લાન	Plan
વર્ગને	to class
સાસ	Saas
ફ્રિ	Free
કપિલદેવ	Kapil Dev
ચહેરાને	to the face
શર્લિન	Sherlyn
અક્ષરા	Akshara
વ્યાવસાયિકો	Professionals
અર્થતંત્રઃ	Economy:
ઉપરાંત	Plus
રૂપરંગમાં	In form
આપી	Given
ભૂકંપ	Earthquake
ઇમેજને	to the image
મેડમ	Ma'am
આનંદો	Joys
રાહુલની	Rahul's
માન્યું	believed
કમર	waist
સસરા	Father-in-law
ચેનલ	Channel
2016ની	of 2016
બીમારી	Illness
ઇલયાનાની	Ilayana's
શરૂ	Start
વાગ્યા	it's time
સ્ટોરેજ	Storage
લાઇનો	Lines
હૉટ	Hot
ગવર્નરનો	Governor's
કોર્સથી	From the course
દત્તા	Dutta
ચિંતા	concern
ડર્યા	Scared
કાતિલાના	Katilana
જામીન	bail
ફોર્બ્સના	Of Forbes
મંગાવી	Ordered
ડોલરના	Dollar
કાતિલ	Qatil
થઈને	by
સટાસટ	Satasat
ભવ્ય	gorgeous
જાય	goes
લગભગ	about
પાસવર્ડ	Password
અનન્યાને	Ananya
પોતાનો	own
ખુબસુરત	Beautiful
ગૂગલની	Of Google
જલેબી	Jalebi
ઉમંગ	Umang
શકાય	Can be
કોમ્પ્યુટરને	to the computer
કડકભૂસ	harsh
અફવાનું	Rumors
કઇ	Which
તૂટ્યો	Broken
છવાયો	covered
લવલાઈફને	To LoveLife
પ્રુફ	Proof
બાળકોનું	children's
સખીયાની	Sakhiani
યુવતીની	of the girl
સેલિબ્રિટીઝ	Celebrities
નાણામંત્રીની	Finance Minister's
એક્સપર્ટ	Expert
નાસ્તો	breakfast
દાયકામાં	in the decade
મજા	Fun
સુધારવા	To improve
રેમ	Ram
કોન્કલેવમાં	At the conclave
અટેક	Attack
તુટયો	broken
જુવો	Look at
ભાભીનો	Sister-in-law's
સેમસંગનો	Samsung's
છેલ્લો	Last
પાવર	Power
અબૂ	Abu
આઇપેડ	iPad
રિદાનની	Ridan's
મલાઇકા	Malaika
દેવગનની	Devgan's
કુરીયરથી	From courier
સ્પોર્ટી	Sporty
જાણવો	Know
વધારો	Increase
જાન્યુઆરીમાં	In January
સુધારાને	To update
અચકાયો	hesitated
મિથુનનાં	Mithun's
શિવસેનાએ	Shiv Sena
ચોપડાએ	Chopra
દેશ	country
કાલી	Kali
આગની	of fire
ચાવલાએ	Chawla
ડાઉ	Dow
લીટરે	Literre
બહેને	Sister
બહુનાં	Too many
રેકોર્ડ	Record
વાઇરલ	Viral
શાહરુખે	Shah Rukh
હોવો	To be
રૂપાણી	Rupani
કર્મચારી	Employees
અમેરિકી	American
ગર્લફ્રેન્ડે	girlfriend
ઝડપે	Fast
વાંચજો	Read
માશૂકાને	Mashukane
કુસ્તી	Wrestling
તબક્કો	Stage
સર્વેક્ષણ	Survey
ઉતર્યા	landed
દેખ	Look at
દત્તાને	To Datta
હોટલ્સમાંથી	From hotels
મજબૂરી	forced
ગ્રેચ્યુઇટીમાં	In gratuity
ખંખેરી	Khakhri
માપી	Measured
બેંકોને	to the banks
મૂક્યો	placed
ઊભી	Standing
ત્રિપુર	Tripura
બીજા	Other
તરસ્યા	thirsty
હોઈ	Be
જોઈ	Viewed
શેયર	Shares
જોડીઓને	Pairs
ન્યૂઝ	News
યુનિક	Unique
મહિલાઓનું	of women
મચ્છરોએ	Mosquitoes
ચૂંટણીકાર્ડમાં	In the election card
ફેન્સના	fans
કાપડિયાનો	Kapadia's
ચોકીદાર	Watchman
399ના	Of 399
બિલમાં	in the bill
થોડો	A little
બીમારીમાં	In illness
અફલાતૂન	Aflatoon
થાપણદારોના	of the depositors
દગો	Cheating
પાકની	of the crop
હવામા	in the air
51મો	51st
કાઉન્સિલની	Of the Council
મહિનાના	monthly
ઇશારામાં	In gesture
અર્પણ	Offering
સજાવાયો	Punished
એપ્લાઇ	Appli
વેંચાઈ	Sold
જ્યાં	where
મુલાકાત	Visit
વેડફાય	Weedaway
પ્રપોઝ	Propose
છેતરપિંડીનો	fraud
નવેમ્બરના	November
ઇન્ટેલિજન્સ	Intelligence
પંડિત	pundit
વિરોધમાં	in protest
બેક	Back
સમસ્યામાં	in problem
પરિસ્થિતિને	the situation
આઇએએસ	IAS
10180ની	10180
વ્યક્તિઓના	individuals
દર	Rate
પુરસ્કાર	Awards
થવાથી	being
ફેસબૂકને	To Facebook
સુનાવણી	Hearing
સેલિબ્રિટીઝનાં	Of celebrities
નિયમો	Rules
બાસુનો	Basu's
જબરદસ્ત	Tremendous
સોનુ	Sonu
વિદેશથી	from abroad
હડતાળથી	from the strike
કરોડમાં	in crores
વટાવશે	will cross
ચર્ચામાં	In the discussion
હેડ	Head
બોલીવૂડને	To Bollywood
રાષ્ટ્રપતિથી	From the President
જોડી	Pair
ફિલ્મમાં	In the film
આશ્ચર્યમાં	In surprise
પીઠી	Pithi
એવોર્ડ્સમાં	At the awards
શોનાં	Of the show
ચેરમેનના	Chairman's
બ્રિટેન	Britain
એનાયત	Awarded
સુંદરીઓનો	of beauties
7800ની	7800
ખતરાના	of danger
અમિતાભ	Amitabh
કેટલાક	Some
કોચના	Coach's
થાકી	Tired
ઇવેન્ટમાં	At the event
કેશબેક	Cashback
કર્ણાટકમાં	In Karnataka
તોફાની	Stormy
તસવીરોથી	from pictures
બીચ	Beach
સિલિન્ડરનાં	of cylinder
સ્કિમથી	From the scheme
2018ને	To 2018
ફેઇમ	Fame
માલિકને	to the owner
હિન્દોસ્તાન	Hindustan
ટર્નઓવરને	turnover
બેડી	Baddie
લખાયેલી	Written
ફિલ્મ્સમાં	In Films
શરણાઈ	Refuge
મહિનો	month
ટચસ્ક્રિનની	of touchscreen
દોઢ	One and a half
શિલ્પાથી	From Shilpa
શેટ્ટીનાં	Shetty's
તેલમાં	In oil
સોનેરી	Golden
છપ્પન	Chhappan
મહિલાઓને	to women
ચાર્જ	Charge
પ્રમાણે	As per
ડબ્બાની	Binney
દિવ્યાંગો	Divyangs
અમેરિકાથી	from The United States
પટેલને	Patel
એશિયન	Asian
ઑફ	Off
કરવાથી	By doing
કાલ	Tomorrow
લીલા	Green
અહીથી	From here
લઇને	Take
ઓનલોકેશનની	of onlocation
જરૂરિયાતની	of need
નાચી	Dancing
શોષણમાં	In exploitation
ઇઝ	Is
ભાર	Load
વર્ષે	Year after year
27500ની	27500
માથે	On the head
ઈઝ	Is
સોંગ	Song
રેડ	Red
ભેટઃ	Gift:
1લી	1st
પ્રોજેક્ટ	Project
જીતેન્દ્ર	Jitendra
વિગતો	Details
રાયે	Raye
લેસ	Les
ફોટો	Photo
જામનગરમાં	in Jamnagar
ગગડતા	grumbling
ભાડાનું	Of Rent
સિંહનો	of the lion
મીડિયા	Media
ફોને	Phone
વિનિતા	Vinita
ગુડી	Goody
પરફોર્મન્સ	Performance
એરલાઇન્સ	Airlines
અમાયરા	Amyra
જગ્યાએ	in place
રાઇડ	Ride
ધૂપિયાના	Dhupiyana
કરનારના	of the doer
આશ્વાસન	Reassurance
વાપીમાં	In Vapi
સ્મોલ	Small
કમાન્ડોની	commandos
મોમા	Moma
રાજકપૂરની	Of Raj Kapoor
લીયોનીનો	Leoni's
ગ્રીન	Green
સપાટીએ	on the surface
થનારા	To be
કેવો	How about
ઝાંસી	Jhansi
છોડવાની	Quitting
ખેતીથી	From agriculture
વોચ	Watch
પાછળ	behind
બનાવાયા	Created
આસમાની	Asmani
ભપોમ	Bhapom
સ્કિમમાં	in the scheme
ખુબસૂરત	Beautiful
કંકોતરી	Kankotri
મમ્મી	Mom
તન્નાનો	Tanna's
મિત્રોને	To friends
મદદ	Help
ડૅટા	Data
બેંકમાં	In the bank
તમારું	your
ગર્લફ્રેન્ડને	To the girlfriend
પ્રેગ્નેન્સીનાં	of pregnancy
નહીંતો	otherwise
બંદિગીએ	Bandigi
પ્રિયંકાની	Priyanka's
અકબર	Akbar
યુનિવર્સિટીએ	The University
કપિલનું	Kapil's
તને	You
હવાઇ	Hawaii
પીહૂ	Pihu
ટ્રંપ	Trump
હદો	Boundaries
એક્સપોર્ટ	Export
નુડલ્સમાં	In noodles
મોડલે	In the model
ઇશાન	Ishan
ભળકોઃ	Mix:
છવાઇ	Chhawai
ઝકરબર્ગને	To Zuckerberg
વિક્રમ	Vikram
સ્ટાફનું	of the staff
ઉદ્યોગો	Industries
વિરોધઃ	Protest:
2018નાં	Of 2018
ઘડ્યો	Created
હાર્ડવેર	Hardware
પૈસાની	Money
નવાબ	Nawab
મતભેદ	Differences of opinion
સ્માર્ટફોનનો	of the smartphone
પડાપડી	padapadi
લિડ	Lead
ભરો	Fill out
આકાશ	sky
શર્ટમાં	In shirt
લુલિયા	Iulia
રાતનું	of the night
ભૂજમાં	in Bhuj
મારુતિની	Maruti's
ખિતાબ	Title
વેચશે	will sell
હાથી	elephant
શિબાની	Shibani
નવેમ્બરે	November
સુનીલ	Sunil
રહેલી	Remaining
પ્રોડ્યુસરનાં	Producer's
અબજપતિ	billionaire
મોટરસાઈકલનું	of a motorcycle
મેલ	Mail
ટોલનાકું	Tolnaku
પુત્રીએ	the daughter
મુસાફરોને	to passengers
પાદુકોણે	Padukone
ગયા	gone
અંતરિક્ષની	of space
અન્ડર	Under
જલાવી	Burning
રોઈ	Roi
ભવન	Bhavan
કંગનાએ	Kangana
પાર્થિવ	Parthiv
જાજરમાન	Jajarman
ટ્રેન્ડ	Trend
પ્રિયંકાએ	Priyanka
કુમકુમ	Kumkum
ઈમેજ	Image
જીતમાં	In victory
અનિશ્ચિત	Uncertain
વ્યય	Expenses
બોલશો	Speak up
ચેનલોના	of channels
મહેતાનું	Mehta's
જેક્લિન	Jacqueline
ઇરફાનને	To Irrfan
યૂઝર્સની	of the users
અટકી	Paused
ઈન્ડિયા	India
હડતાળમાં	In strike
વેપારીઓની	of the traders
વઘારે	Vaghare
આડેધડ	Awkward
આવાસ	Housing
ફર્યો	Turned around
5મી	5th
અનિલ	Anil
વસ્તુ	object
એરની	Airney
રોકા	Roka
પહેરવામાં	To wear
લગાવવા	To install
જોડે	with
હુડ્ડા	Hooda
ધમાલ	Dhamaal
2018ના	Of 2018
ભાગ્ય	Luck
1974માં	In 1974
સદીઓથી	over the centuries
આવ્યાં	came
લુકે	Luke
જેથી	So that
ચૂક્યા	have already
કપાળે	On the forehead
પાર્ટનરશિપ	Partnership
ટાયરવાળી	tiered
ચીજ	Thing
નવ્યા	Navya
બોય	Boy
વિકૃત	Deformed
કહીં	said
ફિલ્મે	Film
પોસ્ટપેડની	Of postpaid
અચ્છે	Achche
પેટ્રોલિયમ	Petroleum
વ્યાજદરોમાં	In interest rates
મહેલ	Palace
તમારો	Yours
ખાધો	Eat
હોંગ	Hong
ડાકુ	Dacoit
ચોપરાની	Chopra's
યુદ્ધ	war
નાયરા	Naira
નોંધણી	Registration
ઓબેરોય	Oberoi
નોકરીથી	From the job
લાશ	corpse
પડવા	Falling
દીક્ષિત	Dixit
મુદ્દાને	to the point
દાવો	Claim
પહેરે	Wear
મિત્રતામાં	In friendship
કીટ	Kit
લાખેણી	Lakheni
નોટોનો	Notes
પરીક્ષા	examination
મીરા	Meera
વૃધ્ધો	Old people
પોલિસીને	to the policy
વિભાગની	Department
બંધુનો	brothers
રોકાઈ	Stopped
બદલ્યુ	Changed
શોધ	Search
ડ્રોપ	Drop
મનમર્ઝીયા	Manmarzia
વેરિફાઈ	Verify
છપ્પર	Chhappar
ચિફ	Chief
દ્રષ્ટી	Vision
લગ્નને	To marriage
રાજસ્થાનના	Rajasthan
ઉઠશો	Get up
આહ	Ah
એટલા	So much
અનુભવું	Feeling
સસૂરાલ	Sasural
ટ્રાન્સફોર્મેશન	Transformation
નફામાં	in profit
વૉલ્ટર	Walter
ચૂડી	Churi
ટીવીનાં	TV's
નહિતર	otherwise
કર્યા	done
સ્વિમિંગ	Swimming
યુવતી	Girl
ઈન્ડિયાની	Of India
જોરશોરથી	Loudly
ફેસબુકે	Facebook
ઈડીએ	EDA
ઇન્ડસ્ટ્રીનો	of the industry
ટર્ન	Turn
ત્રોફાવી	Trofawi
બજેટ2017	Budget 2017
ટેંશન	Tension
ભરવાની	To fill
ચાલતા	Walking
ઇકોનોમિસ્ટ	Economist
હિમાલય	Himalaya
ગાડીઓનું	of cars
જલદી	Soon
એંધાણ	Andhan
કાઉન્સિલ	Council
ગ્રાહકોનાં	of customers
મૂકવા	To put
લડી	Fighting
સ્પોર્ટસ	Sports
ડેલી	Daly
મોકલીશ	I'll send
જૂનો	Old
માલદીવમાં	In the Maldives
સર્વેમાં	In the survey
કૌભાંડઃ	Scam:
ઘેરાયેલા	surrounded
ગભરાઇ	Panic
14મીએ	On the 14th
જોબ	Job
રેટિયો	Retio
ટીમે	Team
ગિટાર	Guitar
આનંદીબહેનની	Of Anandiben
મિશન	Mission
સુલ્તાન	Sultan
કપલનો	of the couple
કાપશે	will cut
રિફંડ	Refund
આરબીઆઇ	RBI
કોંગ્રેસે	Congress
અવતાર	incarnation
ધોરણના	of standard
ઘણી	Too many
ખેલાડી	Player
ડુંગળીએ	Onion
20નો	Of 20
શ્વાસ	breath
કેમેરાને	to the camera
સફર	Trip
ટેમ્પરેચર	Temperature
75નો	Of 75
નુકશાન	Losses
ચમક	Shine
ચોથો	Fourth
ભરાયો	Filled up
ફેમસ	Famous
પિક્ચર્સ	Pictures
લિપલોક	Liplock
સપોર્ટમાં	In support
મોદીજી	Modiji
સૈફે	Saif
પસ્તાવવાનો	To repent
ઔર	Aur
ઝાનું	Jhano
નકલી	Fake
મહાનાયક	Mahanayak
જિયો	Jio
જોહરે	Johar
પડ્યું	Fell
કેટલો	How much
આંદોલન	Movement
યૂઝરે	User
જોરદાર	Excellent
અંદાજથી	By estimate
બોરિયા	Boria
મર્જરથી	from the merger
બનશે	will be
વેલીની	Velini
ભિખારી	beggar
હિન્દુસ્તાની	Hindustani
ગગળ્યો	melted
સિતારા	Sitara
પુર્ણ	Full
સોનાના	Of gold
અકાઉન્ટમાં	In the account
સેકેન્ડમાં	In seconds
26ની	Of 26
રાઉન્ડમાં	in the round
અનમોલ	Anmol
કૌભાંડમાં	in the scam
આરબીઆઈના	OF THE RBI
ઘણો	A lot
સોનાલીની	Sonali's
ઝટકોઃવેપાર	Jolt: Business
ઑનલાઈન	Online
ફેમિના	Femina
જમાનાની	of the era
રાજીવ	Rajiv
બરાબર	Okay
લીધા	Taken
ધર્મેન્દ્રની	Of Dharmendra
થોડી	A little
નિયા	Nia
સબસિડીનો	of subsidy
વધાર્યા	Increased
શરદી	Cold
ઝફરે	Zaffar
વગરનો	Without
ઘરનું	of home
કહો	Say
ગ્રોવરને	Grover
સ્લો	Slow
મગફળીના	Peanuts
સખત	Hard
પેન્શનર્સના	Pensioners'
બ્લંટ	Blunt
સ્ટાઇલમાં	In style
ડ્રેસને	To the dress
રહેવા	To stay
લેખિકાએ	The author
વગાડી	Played
ટ્રાંસફરમાં	In Transfer
કપડાંમાં	In clothes
કર્મીનું	of the worker
મહારેલી	Maharally
રેપની	Repany
ઓગસ્ટથી	From August
સિંઘાનિયાની	Singhaniani
સ્ક્રીનિંગમાં	At the screening
નહોતો	Not
વિન્ટેજ	Vintage
સોનાનાં	of gold
યુવક	Young man
પદેથી	From the post
અંગદે	Angade
વિડ્રોઅલ	Vidroal
જવાબમાં	In reply
જિયા	Jia
લિવ	Liv
વિવેકાનંદ	Vivekanand
જવી	To go
સ્ટાર્સથી	From the Stars
સસ્પેન્ડ	Suspended
બે	Two
રુપિયો	Rupee
નિશાન	Mark
અનિશ્ચિતતા	Uncertainty
વિંગેટ	Winget
કેન્દ્રીય	Central
રોમેન્સ	Romance
નીલેશ	Nilesh
રૂપર્ટ	Rupert
હત્યા	murder
આશીર્વાદ	Blessings
મેગન	Megan
ઉડો	Fly
આઠ	Eight
મહિના	months
એશિયાના	Asia
મંદીના	of recession
ખલનાયક	Villain
વારંવાર	repeatedly
એકટ્રેસને	To the actress
પરિવર્તન	Change
શહીદોને	to the martyrs
પૈસાને	to the money
સંસ્કારમાં	in culture
પેડમેનનું	Padman's
આમિરનો	Aamir's
જેનો	Whose
ઈમ્પોર્ટ	Import
જાણીને	Knowing
આઘાતમાં	in shock
પકડાઇ	Caught
રૂમાં	in rupees
ઇજાગ્રસ્ત	injured
જેમણે	those who
પંખો	fan
ઓકતા	Okta
કપૂરને	To Kapoor
જરુરિયાત	Needed
ગર્લનો	Girl's
સાચુ	True
ચીનનો	Of China
ગતિશીલતા	Mobility
ટોળુ	the mob
તોફાને	Storm
ક્રેઝી	Crazy
શોપિંગ	Shopping
થનારી	To happen
ફેલાઇ	Spread
દંડનાત્મક	punitive
પાર્ટનરને	to the partner
કોન્ટેક્ટ	Contact
દીકરાની	of the son
લેડી	Lady
હોંગકોંગ	Hong Kong
પદ્ધતિથી	By method
ફસાઈ	Trapped
પ્રેગ્નેંટ	Pregnant
મુકવામાં	to be placed
તોડશે	will break
અમિતાભથી	From Amitabh
ચીમકી	Chimki
અધ્યક્ષ	Chairman
જ્યોતિષ	Astrology
હસ્તે	Hand in hand
આઇટીના	OF IT
અરશદ	Arshad
દેસાઇ	Desai
અઠવાડીયાના	of the week
સપાટી	Surface
ફેરફારોને	Changes
વ્યક્તિઓને	to individuals
વોટીંગથી	by voting
આભાર	Thank you
શકે	may
ટિકિટથી	By ticket
એકને	to one
અભિનેત્રીના	Of the actress
લાકડાની	of wood
સ્ટેન્ડનું	of the stand
ધૂળેટી	Dhuleti
બચ્ચે	The baby
રચાશે	will be formed
જિંદગીમાં	In life
000ને	To 000
કાશ્મીરનાં	Of Kashmir
રાજામૌલીના	Rajamouli's
સિહ	Sih
દલીલ	Argument
ફેસ	Face
તરખાટ	Tarkhat
બની	became
મિસ્ટ્રી	Mystery
રિલીઝનાં	Of release
નવાજવામાં	In The New
ખુરશી	chair
સાંભળી	Listening
સિંદૂર	vermilion
રિસોર્ટમાં	In the resort
હવાથી	from the air
એકસાથે	Together
કપિલનો	Kapil's
મેહુલ	Mehul
બૂથ	Booth
સેલિબ્રેટ	Celebration
10150ની	10150
જીવતી	Living
બ્રેગ્ઝિટથી	From Brexit
અજાણ	Unknown
કરનારી	Doer
ટાઇમ	Time
જાસુસ	Detective
દેહને	body
મેકિંગ	Making
અછતથી	from shortage
પહેરવાની	To wear
વિવાહ	Marriage
979માં	In 979
પ્લાન્સ	Plans
પડ્યાં	fell
અભિનો	Abhi's
ચેન્નઇ	Chennai
નંદાનાં	Nandana
તબિયત	Health
તલપડેનાં	Talpadena
બેન્કની	of the bank
સોમાનની	Of Soman
જજ	Judge
કોચરના	Kochhar's
વેચીને	By selling
ઠુમકા	Thumka
આકર્ષિત	Attracted
નોટની	Notes
પહોંચ્યા	arrived
શિવરાત્રિ	Shivaratri
ઇચ્છે	Wants to
સ્ટાફમાં	In staff
ભાગેડુ	Fugitive
આપ્યું	Given
તેણે	He
એક્ક્ષ્પોર્ટ	Exxport
ફોટોગ્રાફર	Photographer
ધનવાન	Rich
ઇરાનને	To Iran
જેક્લિનનો	Jacqueline's
એકટ્રેસે	Actress
કબજે	occupied
મલહારની	Malhar's
ઇશા	Isha
રૂમનું	of the room
એસટી	ST
1રૂપિયાની	1 rupee
કાઉચનો	Couch's
મુફ્તીને	To Mufti
સોમવારથી	From Monday
ડઝનથી	Over a dozen
થાઇલેન્ડમાં	In Thailand
વર્ષો	years
બનાવે	Creating
માલકિન	Malkin
ટ્રેડિશનલ	Traditional
આવતા	Coming
ચશ્માને	glasses
ટ્રેનિંગ	Training
ફ્લાઈટમાં	In the flight
મંત્રી	Minister
ઝાટક્યો	Jerked
મળી	Found
કાતીલ	Qatil
ભડકાવી	instigation
વોગ	Vogue
મેક	Mac
હેટ	Hat
જેનાથી	by which
સમુદ્ર	sea
વિરે	Vire
દૂર	Away
રહેલાં	staying
કસૌટી	Kasauti
સ્વિટ્ઝરલેન્ડ	Switzerland
ઇન્‍ડિયા	India
કારો	Cars
અક્કીની	Akkini
100નો	Of 100
મોકલો	Submit
હોટલના	of the hotel
હીરામાં	In diamonds
બહાર	Outside
ધરપકડ	Arrested
ગુજરાતી	Gujarati
દ્રષ્ટિ	Vision
શ્રીગણેશ	ShriGanesh
સનસની	Sensational
મુમતાઝના	Mumtaz
ઉદ્યોગના	Industry
દેશોમાં	in countries
કાળિયાર	antelope
અફવાઓ	Rumors
આના	Of this
સિલિન્ડરના	of the cylinder
કલાકથી	for hours
નાનું	little
ગણાવ્યો	counted
ગાંઠોના	of the lumps
ઈન્ગેજમેંટ	Ingestion
તળિયે	At the bottom
સાહો	Saaho
આયોગે	Commission
બેઠા	Sit down
સ્થિત	located
લાભ	Benefits
અલર્ટ	Alert
બોયકોટ	Boycott
મહેંગા	Mehnga
રસપ્રદ	Interesting
કાલથી	From tomorrow
હતું	Have been
આમિર	Aamir
વીજળી	electricity
પાયલટનાં	Of the pilot
10570ની	Of 10570
ઉમટ્યુ	Umtu
આરટીઆઈ	RTI
કમાઓ	Earn
ઝુકરબર્ગ	Zuckerberg
પુરાઇ	Purai
ભારતીયોનું	Of The Indians
ચેનલો	Channels
સીલિંગ	Sealing
પિતા	Father
લોકોને	people
બળજબરીથી	by force
તિરાડ	Crack
વિઝન	Vision
શકળો	Able
સિક્કાથી	From the coin
ફોટોગ્રાફર્સને	To photographers
અધિકારીઓએ	Officials
અક્ષયથી	From Akshay
સંજૂ	Sanju
ખાતાઓ	Accounts
પ્રોડ્યુસરનો	Producer's
રૈમ	Ram
ટ્રિકથી	From the trick
સસ્તા	Cheap
કહ્યું	said
મોહિતની	Mohit's
ટોલર્સે	Tolers
લાવવુ	Fetching
સ્વિફ્ટ	Swift
આયાને	Ayaane
ઇતિહાસમાં	In History
આરોપો	Allegations
યુવાઓ	Youth
મોબાઇલ	Mobile
ઓળખી	Identified
વોટ્સએપ	WhatsApp
હજારના	of thousands
જોધપુર	Jodhpur
પ્રખ્યાત	distinguished
અક્ષરાનો	Of Akshara
માધુરી	Madhuri
બાબૂજી	Babuji
તેજી	Boom
કોહલીએ	Kohli
2019ના	Of 2019
મધમાખી	bee
કન્ફર્મ	Confirmed
મિત્રતા	Friendship
ક્રૂ	Crew
પ્રોત્સાહન	Encouragement
હાઉસફુલ	Housefull
એસ્ટેબન	Esteban
સપાટો	Flat
હીટ	Heat
હેરસમેન્ટનો	of harassment
રાજપાલ	Rajpal
ચાલે	Let's go
ઇનાયાએ	Inaaya
પોઝ	Pose
મંગાવ્યા	Ordered
નવરાત્રી	Navratri
પાટિલ	Patil
વેપારીઓને	To the traders
ફેડરલ	Federal
જનધન	Jan Dhan
દોસ્તોનો	of friends
મહિલાના	Woman's
ખુલ્યાં	Opened
ફસાયા	Trapped
હજારથી	Thousand
લટકી	hanging
ધૂમ	Dhum
પ્રભુદેવા	Prabhudeva
ડોલ્સ	Dolls
જુમ્મે	Jumme
સિક્કા	Coin
સેન્સેક્સે	Sensex
છીએ	are
હજારનો	of thousand
ફ્લિપકાર્ટ	Flipkart
જસલીન	Jasleen
રેશમિયા	Reshammiya
રાજનેતાના	Of a politician
બ્લેકમેઇલનો	of blackmail
મેગા	Mega
અર્જૂન	Arjun
મેગી	Maggie
દવાની	of medicine
કિંમતવાળા	With value
માલ્યાની	Mallya's
બાનોએ	Bano
માલ્યાના	Mallya's
ટીંગાઈ	Tingai
જૈકલીન	Jacqueline
ખોરંભે	Khorambhe
રાખતી	Keeping
કોરા	Kora
ધાગા	Dhaaga
સેવ	Save
મન્ટો	Manto
ઉપાડી	Picked up
સેલ્ફિશ	Selfish
હોવાનો	to be
રેડમી	Redmi
દિલ્હીની	Of Delhi
વાયરસનો	of the virus
રૂપિયાનો	Rupees
આવ્યા	came
લટકા	hanging
ફિલ્મોમાં	In films
1000થી	From 1000
વ્યાજદરો	Interest Rates
મિસ	Miss
જયારે	When
બોલબોલા	Bolbola
સહિતના	Including
આરકે	R.K.
ઉકેલ	Solution
વેક્સિંગ	Waxing
રાજકુમાર	Prince
10ની	Of 10
થોડાક	A few
કા	Ka
કડાકો	Kadako
રજની	Rajini
અનુરાગ	Anurag
મુશ્કેલીઓ	Difficulties
મહેંદી	Mehndi
હેઝલ	Hazel
બોલિવૂડે	In Bollywood
ઓનલાઇન	Online
ઈનામ	Prize
લોપેઝે	Lopez
વૃદ્ધિનો	of growth
સમયની	of time
બૂક	Book
ઝડપી	Fast
પાંચ	Five
સુધીમાં	by
કરેન્સી	Currency
ટૉકટાઇમ	TalkTime
લોકેશ	Lokesh
ભાગી	Run away
દરેક	every
રણવીરના	Ranveer's
નિર્દેશક	Director
મહત્વ	Importance
વચ્ચે	In between
નવુ	New
રેશમિયાએ	Reshammiya
કાઉન્સિલે	Council
સુવર્ણ	Golden
ફાઉન્ડર	Founder
રાધિકાની	Radhika's
સંસ્થાપક	Founder
અનલોક	Unlock
બેકાર	useless
લીલાવતી	Lilavati
યૂઝની	Eusnie
સહેવો	Easy
પલડી	turning around
કલરનું	Color
પ્રિયંકાનાં	Priyanka's
માઈક્રોમેક્સ	Micromax
અંગ્રેજી	English
પ્રારંભ	Start
કરિનાએ	Kareena
બંનેમાં	In both
એપ્લિકેશન	App
મારતો	Hitting
સોફી	Sophie
તૈમૂરે	Timur
ચૂપચાપ	Quietly
રિઝર્વેશન	Reservation
ઇનકાર	Denial
પ્રતીક	Symbol
તકે	At the same time
મોઘો	Mogho
બબ્બરની	Babbar's
વીજ	Electricity
આંધ્રપ્રદેશ	Andhra Pradesh
સેટિંગ	Settings
વિધવાઓનું	of widows
શુઝની	Shuzzi
મહત્વપૂર્ણ	Important
મુસ્કાન	Muskan
પ્રારંભે	At the beginning
ભ	Bha
બાદલ	Badal
ચોથા	The fourth
તારક	Tarak
મન	mind
બનાવી‘મોર્ડન	Made 'Modern'
કરોડોનું	crores of rupees
સૂદનો	Sood's
અપમાન	Insult
જાસૂસીનું	of espionage
યાદગાર	Memorable
જૂનમાં	in June
પ્રદર્શનઃ	Display:
ડિફોલ્ટર	Defaulter
અનલિમિટેડ	Unlimited
સીખીને	by learning
ટાઈમ	Time
134ની	Of 134
બોટલોથી	from bottles
અલ્ટોમાં	In Alto
કન્ટેન્ટ	Content
હસિના	Hasina
ચાલ્યા	Went on
રશેલ	Rachel
બચવા	To escape
ફૅક	Fack
નેતા	Leader
નીના	Nina
પન્નૂની	Pannuni
પ્રતિકિલો	per kg
ક્યારથી	Since when
મારૂતિએ	Maruti
બતાવી	Shown
સ્ટેપ્સ	Steps
રાઝ	Raaz
પ્રધાનમંત્રી	Prime Minister
માલૂમ	Malum
દેવડ	Devad
બદલાવો	Changes
2019નું	Of 2019
ડિલીટ	Delete
આસમાને	In the sky
નવી	New
વાકાણી	Vakani
આધારને	To support
ફાઉન્ડરનો	Founder's
બીજુ	Second
ખૈર	Khair
માણીને	Enjoying
રોશને	To Roshan
ઓપરેશન	Operation
વસ્તુની	of the item
ગૌરવ	Pride
દુકાન	shop
મળે	Get it
ચીટ	Cheat
ચૂંટણીની	Elections
લૂકમાં	In the look
મણિકર્ણિકા	Manikarnika
પર્દાફાશ	Exposed
બદતર	Worse
પેટ્રોલમાં	In petrol
રાયઝાદા	Raizada
અબજોપતિ	Billionaires
બોલ્યો	spoke
મહારાષ્ટ્ર	Maharashtra
સ્વર્ગ	Heaven
બાપાનું	Father's
છવાયા	Chhavya
દઈશ	I'll give
કાઢાવાની	To remove
શૅર્સમાં	In shares
ગાર્મેન્ટ્સ	Garments
કોડીનારમાં	In Kodinar
કઢાવવા	To remove
વધે	Grows up
તેજવાનીની	Tejwani's
20માં	In 20
માછીમારોની	of fishermen
એન્ટિલિયા	Antilia
એક્સસાઇઝ	Exercise
જેકેટમાં	In the jacket
મેળવવામાં	In getting
રાજકિય	Royal
સાહેબ	Sir
માધુરીને	To Madhuri
છુટકો	Escape
રાખીનો	Rakhi's
વિશેષ	Special
ક્વાન્ટિકો	Quantico
1કરોડનો	1 crore
ઓફિસની	office
લાઇસન્સ	License
જોનીની	Johnny
49માં	In 49
ચીની	Chinese
આકર્ષણનું	of attraction
પેનલ્ટી	Penalty
જોનસ	Jonas
છેઃઅરૂણ	: Arun
જૂના	Old
શર્માના	Sharma's
ઝુંપડીમાં	in the hut
સેરેમનીની	Ceremoni
હાઇકોર્ટમાં	In the High Court
ડિઝલના	Of diesel
સરકારી	Government
દેવાળિયું	Bankrupt
પ્રિયંકા	Priyanka
વિટારાના	Vitarana
ચેનલના	of the channel
દાખલ	Entered
કોંગમાં	In Kong
ફેસબુકથી	From Facebook
કૈફે	Cafe
મેનકા	Menaka
કોમોલિકાની	Komolika's
બંગલે	Bungalow
ચાંદની	Moonlight
નોકરીઓ	Jobs
ભાડવાતે	Tenants
ચેરમેન	Chairman
બેન્દ્રે	Bendre
કિડનીની	of the kidneys
ફસાયેલા	Trapped
તાળાં	Locks
ફોલ્ડ	Fold
ગુગલની	Google's
મૃણાલ	Mrinal
ડ્રાઇવ	Drive
બરોડા	Baroda
કમાણી	Earnings
સોનમનો	Sonam's
ભારત	India
રેલવેને	To the Railways
રાહુલ	Rahul
હિંદુસ્તાનનો	of India
મુખ્યપ્રધાનને	To the Chief Minister
લાઇફની	of life
શહાણે	Shahane
સેલનો	Of the cell
પ્રોડ્યુસર	Producer
રોયે	Roye
હાર્વર્ડ	Harvard
બલી	Bali
સંભાળવો	Handle
લોનનો	of the loan
લિટરે	Literae
ગંદકી	Filthy
કનેકટીવિટીના	Of connectivity
આદેશ	Command
ઝકરબર્ગનો	Zuckerberg's
જોયો	Saw
બગે	Bage
દોડાવશે	Will run
પીડાય	suffering
લાઇટ્સ	Lights
સામના	Saamna
ઉઠાવીને	By picking up
ફ્લોટિંગ	Floating
સૂંઘતો	Smelling
ઉદ્યોગની	of the industry
ઈંગ્લેન્ડમાં	in England
મનિષ	Manish
કેન્દ્રના	Centre
ફાઈટર	Fighter
દુલ્હન	The bride
બેંકોએ	banks
દત્ત	Dutt
સુધી	until
વેલેન્ટાઇન્સ	Valentine's
છેઃ	:
મેસેન્જરમાં	In Messenger
આરાધ્યાની	Aaradhyani
કરાણ	Karan
જેકેટ	Jacket
ટેકો	Support
રાંધણ	Cooking
લૉન	Lawn
અગ્રણીએ	Leading
મહીને	monthly
ઈન્ડીયા	India
સ્વરા	Swara
ગોપીનાથ	Gopinath
જેકલીનનો	Jacqueline's
રાવને	Rao
દીપિકા	lamp
લીટરમાં	in liters
ખરીદવાની	To buy
રિઝર્વે	Reserve
પાકિસ્તાનના	Of Pakistan
ઇન્ફોસિસના	Of Infosys
સેલેબ્સનો	Of celebs
એડીશન	Edition
વિટારા	Vitara
ઉંચી	High
ઉપાયો	Remedies
કેરી	mango
મહેંદીને	Mehndi
વેંચવા	To sell
આતશબાજીથી	From fireworks
ઈન્વેસ્ટમેન્ટ	Investment
હિરાની	Hirani
બ્લેક	Black
પૈસાનાં	of money
સીધી	Straight
બેદી	Bedi
000નું	Of 000
મેનન	Menon
આભૂષણો	Ornaments
બહેનોની	of sisters
લડાવવા	To fight
લિયોન	Leon
મોર	peacock
એજન્ટ	Agent
વિધીમાં	In Vidhi
કરવો	to do
ઘડાટો	clocks
સટ્ટોડિયો	Speculator
બનાવો	Create
મોટા	Big
990નો	Of 990
ચુકવણી	Payments
આપ્ટેના	Aptena
બોલિવૂડ	Bollywood
પૌત્ર	Grandson
તેવી	Like that
જોહરની	Johar's
બિકની	Bikini
ટોકીઝ	Talkies
રોમિયો	Romeo
સરોજ	Saroj
રસમ	Rasam
છપવા	Printing
વિશેષઃ	Special:
બતાવ	Show
રાજ્યની	Of the State
પહેરાવવી	To wear
હસન	Hassan
સરકારનું	of the government
ટ્રિક્સ	Tricks
બોયફ્રેન્ડની	boyfriend's
કુલર	Cooler
ખુલાસા	Disclosures
પહોંચાડશે	Delivered
સનીને	To Sunny
કાયદો	law
દબાણ	pressure
છિલ્લરે	Chhillare
થયેલો	Done
મહારાષ્ટ્રના	Maharashtra
સરકાની	Sarkany
થ્રોન્સ	Thrones
પાટેકર	Patekar
મધુબાલાને	To Madhubala
ઝિંટા	Zinta
પાર્ટીની	of the party
દંડ	Fine
એક્સિડેન્ટલ	Accidental
અમિતાભની	Amitabh's
રેમવાળો	Ramwala
લગાવી	Put up
આંખમાં	in the eye
નૂડલ્સ	Noodles
આવાં	Such as
લખનાર	writer
નવેમ્બરથી	From November
ટાગોરના	Tagore's
કરતા	rather than
000ની	Of 000
હટાવો	Remove
વડાપ્રધાન	Prime Minister
તૂટવાની	to break down
વટાવી	exceeded
બજેટઃકોર્પોરેટર	Budget: Corporate
કમ	less
આર	R
કઢાવવાનો	To remove
સંભળાવ્યો	Heard
ઇશાને	To Isha
સીરિઝમાં	in the series
એવો	Such is the case
હોટનેસ	Hotness
વેપારીના	of the merchant
જાણીતી	Known
ઉપાધ્યક્ષ	Vice President
ખુલશે	Open
બને	become
હરેશ	Haresh
રજનીના	Rajini's
સભાસદો	Meetings
ગે	Gay
જીતનો	of victory
સૌદમીનીનાં	Saudamini's
કલર્સનો	Of Colors
કોમોલિકાએ	Komolika
શારીરિક	physical
યુવતીના	of the girl
કંપનીઓને	companies
એક્ટ્રેસને	To the actress
કપલ	Couple
ઉકેલાઇ	Resolved
આંકડો	Figures
અર્શી	Arshi
ઝવેરીઓમાં	In the jewelers
તલવાર	sword
મલ્હારની	Malhar's
લાખના	of millions
કરાઇ	Karai
શિકાગો	Chicago
ફર્નાન્ડિઝની	Fernandez
નિકનાં	Nick's
ક્રશ	Crush
ભારતમાં	In India
અનુપ	Anup
ખરેખરમાં	In fact,
ઈન્ડિયન	Indian
સમસ્યા	Problem
ખર્ચીને	by spending
હાલ	Currently,
કરનારાને	To the doer
સ્પીકર	Speaker
કાપ	Cut
વિદેશમાંથી	from abroad
દેશે	Country
હપ્તે	In installments
પહોળાઈ	width
બોલ	Ball
સાથેના	with
આધારની	of support
મીશા	Misha
ઓદ્યોગિક	Industrial
નારી	female
દાન	Donations
મેડ	Med
ગાંધીનો	Gandhi's
યૂનિકોર્ન	Unicorn
સાવકી	Step-step-by-step
મશીનથી	from the machine
ભરનારાઓની	of fillers
જણાવ્યો	Told
ભંગાર	Debris
ચેટ	Chat
ઓક્ટોબરથી	From October
મસ્તીભર્યા	Fun-filled
માહોલ	Atmosphere
અબજથી	Over a billion
ક્રેડિટ	Credit
એક્સપીરિયન્સ	Experience
નેતાઓનું	of the leaders
બેદરકારી	Negligence
હાલના	Current
રિટાયર	Retired
સંજુ	Sanju
તમાર	Yours
મસાલાનો	of spices
મમ્મીની	Mom's
બ્રેકઅપ	Breakup
માનવજાત	Mankind
આંખોથી	with eyes
પેલેસમાં	In the Palace
વિધીથી	From vidhi
સુધીનુ	up to
દાળ	Dal
સંભાવનાએ	Probability
બ્રાઇડલ	Bridal
કેવી	How
મૃત્યુનાં	of death
ભૂલને	Error
જુઠ્ઠી	A liar
કિનારે	On the shore
ભાઈનું	Brother's
રાઘવને	To Raghava
ટેટૂને	Tattoo
પરિવારને	Family
રેલ	Rail
ભરાવતી	Filling in
રહ્યું	has been
હિસ્ટ્રી	History
સજાવી	Decorating
અેશિયાના	Asia's
આર્મી	Army
સ્માર્ટ	Smart
પેડ્સ	Pads
આખા	Whole
રેસના	Of race
શણગારવામાં	In decoration
ક્યારેક	Sometimes
લીટરનો	of liter
બાઈક	Bike
દર્દ	Pain
હેકર્સ	Hackers
ઘરે	At home
ડેડલાઇન	Deadlines
વિદ્યાર્થીને	Student
બાજુમાં	Side by side
સામેથી	From the front
સંકટ	Crisis
વેબસાઇટ	Website
ડુપ્લીકેટ	Duplicate
વ્યાજ	interest
70ના	70
મ્યુઝિયમમાં	In the museum
ઓડીની	Audi's
સેકન્ડોમાં	in seconds
રંગેહાથે	Red-handed
અટકાવશે	will stop
રીફંડ	Refunds
વ્યક્તિનાં	of the person
ચાઈના	China
દયાભાભીએ	Dayabhabhi
ખાતાધારકોને	To the account holders
સોનાક્ષીના	Sonakshi's
રસ્તામાં	On the way
કરોડાના	crores of rupees
જવાનીમાં	In jawani
કાર્નિવલ	Carnival
સિયારામ	Siyaram
તસવીરનો	Picture of
સપ્તાહે	Weekly
સુર્યની	Surya's
ડ્રો	Draw
સીધા	Straight
રિતિકે	Hrithik
ઈ	e
માખી	bees
કંગનાની	Kangana's
ગુલાટીનો	Gulati's
ચોકાવનારું	Shocking
એકલી	Alone
સાચે	Really
મોહમ્મદ	Mohammed
વિવાદો	Disputes
ખલી	Khali
સલમાનને	To Salman
બાથરુમનો	of the bathroom
નક્કી	decided
માસ્ટર	Master
ટ્રમ્પનો	Trump's
હુમલો	Attack
આખું	entire
પિતાને	Father
રોહતગીએ	Rohatgi
કારનું	of the car
6લાખનો	6 lakh
લેન્ડરોવર	Land Rover
બચાવી	Rescued
સગાઈની	Of engagement
સુષ્મિતાએ	Sushmita
રિતેશ	Ritesh
વર્ષનું	of the year
દીપિકાની	Deepika's
કેટરીના	Katrina
પાછી	Back
સાંવતે	Savante
હટાવવાની	To remove
ત્રિમાસિકમાં	in the quarter
ઈબ્રાહિમનો	Of Abraham
સાબિતી	Proof
ગ્રૂપ	Group
કૃષ્ણાએ	Krishna
મજેદાર	Fun
દુલ્હનથી	From the bride
આખરે	At last
36ની	Of 36
ડૉલરના	of the dollar
સેવા	Service
નાગિનના	Nagin's
જાહ્નવીની	Jahnavi's
ખાનના	Khan's
ઇફેક્ટ	Effect
ધમકાવતો	Threatening
કરન	Karan
મળતી	Found
સેન્સેક્સ	Sensex
વર્ઝન	Version
હાઈકોર્ટમાં	In the High Court
પિતાની	Father's
મનીષ	Manish
માઈકલ	Michael
જેનફોન	Zenfone
વર્ષોથી	over the years
હોઇ	Hoi
મળ્યું	Found
લાઇન	Line
શ્રીની	Sri's
હાથીનું	of the elephant
ટોપ	Top
કેબ	Cab
કોમર્સના	Of Commerce
માર્કેટયાર્ડમાં	In the marketyard
ખૂશ્બૂ	Khushboo
ગુજરાત	Gujarat
મહારાષ્ટ્રની	of Maharashtra
ઉઠાવો	Pick up
વોલેટથી	From the wallet
દાગીના	Jewelry
હબ	Hub
ગૃહિણીઓ	Housewives
સ્વાગત	reception
હરેકૃષ્ણામાં	In Harekrishna
76મો	76th
તુષાર	Tushar
સમાપ્ત	The end
ગળેફાંસો	Suffocation
ગાંગુલી	Ganguly
ડિપોઝિટ	Deposit
ડાબો	Left
ટીટૂ	Titu
પાપડ	Papad
ચાંદીના	Silver
બોલીવુડ	Bollywood
ભાવનગરઃ	Bhavnagar:
હિંમતનગરમાં	In Himmatnagar
બિજલાનીઃ	Bijlani:
કંન્ટ્રોલ	Control
ઉઘ	Sleep
મંત્રીની	Minister's
કલાકારોની	of the artists
થી	From
રસમથી	From Rasam
ચાલતી	Walking
પરણવાનાં	To get married
માસ્ક	Mask
રાજ	Raj
રેપ	Rap
લોંચ	Launch
પિતાના	Father's
પદ્મશ્રીથી	From Padma Shri
ડેલિગેટ્સ	Delegates
રાધીકા	Radhika
લાખો	Millions
હજારની	of thousands
દુનિયાભરમાં	Around the world
મુંદરા	Mundra
અમદાવાદમાં	In Ahmedabad
ફેબ્રુઆરી	February
હમ	Hum
રુપિયાનો	of rupees
આરોપોનો	of the allegations
દુબઇની	Of Dubai
નીરવ	Neerav
399નો	Of 399
ગાળામાં	over a period of time
અસ્થમાની	of asthma
કોચરને	To Kochhar
છૂપું	hidden
રિયા	Rhea
બાબરા	Babra
ચોકલેટ	Chocolate
ઓથેન્ટિકેશન	Authentication
મેહંદીનાં	Mehndi's
ઓગષ્ટથી	From August
બેડ	Bed
ડ્રિમ	Dream
એંગલથી	From angle
2018નું	Of 2018
સિમકાર્ડની	OF SIM CARD
પરિણીતી	Married
હોન્ડાની	Honda's
પેટ્ટા	Petta
યોજનાઓ	Plans
ભારતભરમાં	Across India
ડિઝલમાં	In diesel
જેવો	Like
જશે	will go
લિડર્સ	Leaders
31મો	31st
માતાજી	Mataji
ફ્લોન્ટ	Flant
આપતી	Giving
ફિલ્મમાંથી	from the film
પરિણીતિ	Married
બેંકના	Of the Bank
જમવાનું	Eating
રેટ્રો	Retro
બેગમાં	in the bag
નાચ્યો	Danced
આલિયાનાં	Of Alia
જોઇને	Seeing
ડાઉનલોડ	Download
બતાવતી	Showing
સ્ટાઈલમાં	In style
ફાઇટર	Fighter
કંપનીઓએ	companies
દુનિયાભરનાં	Around the world
યાત્રા	Journey
ગાબડાં	Gabdas
કરવાં	to do
ખોટા	False
મફતમાંઃ	Free of charge:
ઐશ્વર્યાની	Of Aishwarya
ગરોળી	Lizard
હિન્દોસ્તાન’નું	Of 'Hindustan'
કહેલાતા	Said
જોવી	Watching
અર્થતંત્રમાં	in the economy
રનૌટ	Runout
માલિકની	of the owner
દારૂના	Alcohol
ફેશન	Fashion
સુહાનાનો	Suhana's
ફોનમાં	On the phone
શેરાવત	Sherawat
ઉત્તર	North
પ્રોજેક્ટઃઅમદાવાદનો	Project: Ahmedabad
મોટું	great
સ્કર્ટમાં	In skirts
એડિશન	Edition
આઈડી	ID
ફેનને	To the fan
સ્ક્રેચને	to scratch
પંખુડીનો	of the wings
વ્યક્તિગત	individual
જલસો	Jalsao
વર્લ્ડ	World
રાખતા	Keeping
સ્પર્ધકે	Contestant
સેક્સ	Sex
કબ્ર	Grave
ક્વિન	Quinn
બેસે	sits down
ગરદન	neck
099માં	In 099
કેશબેકથી	From cashback
ના	No
બેંકથી	from the bank
બ્રેક	Brake
શોખીનો	Fond of
ડોલ	bucket
રહસ્ય	Secret
કામસૂત્ર	Kamasutra
ઘાઇની	Ghaini
લાલુ	Lalu
રિલેશનશિપમાં	In a relationship
બીજી	Another
કહાની	Story
કરશુંઃવિશ્વ	We'll do it: The World
અનુભવ	experience
સ્પિડે	Speede
આક્રામક	Aggressive
કિર્તિ	Kirti
જમ્મુ	Jammu
શકો	You can
માદરે	Madre
જરૂરત	Needed
પ્રિતી	Priti
છેલ્લા	Last
અમદાવાદઃઓર્ગેનિક	Ahmedabad: Organic
ક્યુટ	Cute
ઠૂમકદા	Thumkada
2200નું	Of 2200
શિંદે	Shinde
એટેકથી	from an attack
કોંગ્રેસની	Of the Congress
ભડકી	flared up
કોર્સ	Course
રહસ્યની	Of the mystery
મંડી	Mandi
ગો	Go
પેટ્રોલથી	With petrol
ટ્રાયલ	Trial
માટી	earth
કાઉચથી	From the couch
નાથની	Nath's
તાલીમ	Training
અગરિયાઓની	Of the Agariyas
સિદ્દકીએ	Siddaki
ખેડૂતોનું	of the farmers
પૂરા	Complete
કેટરિનાએ	Katrina
એરબેગ	Airbag
કેશ	hair
રોમાન્ટિક	Romantic
મંજૂર	Approved
હમશક્લ	Humshakals
કર્યે	Karye
હવે	Now
લેસ્બિયન	Lesbian
વાડિયાને	Wadia
ડાયરામાં	In Diarea
લેવાયો	Taken
નોટબંધીમાં	In demonetisation
ઘોડે	Horsemen
મોહાબ્બતે	Mohabbatein
એરટેલે	Airtel
બમણો	Double
સાઇટ	Site
યૂઝ	Use
શબ્દોમાં	In words
ભણસાલીની	Bhansali's
સેન્સેકસ	Sensex
વિશેષતાઓ	Features
ડ્યુઅલ	Dual
સંભાવના	Probability
વેજ્ઞાનિક	Scientific
બદલાશે	will change
સેરેમનીનાં	Of the ceremony
મીરાં	Meera
સરળતાથી	Easily
મિનિટે	minute by minute
ક્રિપ્ટોકરન્સી	Cryptocurrency
માંડી	Start
ચિનના	China's
બેલેન્સનો	of balance
પહેલો	First
ઇન્સ્ટાગ્રામનો	Of Instagram
થકી	through
વાહ	Wah
વ્યાપાર	Business
લોકોનો	people
શોધમાં	In search
કરવાની	to do
સીનની	Of Sean
ક્રિતી	Kriti
કબડ્ડીની	Of Kabaddi
તમારાં	Yours
કાબુમાં	in control
પગલાથી	Step by step
ફુલ	Flowers
અધિકારીઓ	Officers
ધમકીઓ	Threats
ગુપ્ત	Secret
210થી	From 210
ગેબ્રિએલા	Gabriella
વયે	Age
રોસ્ટર	Roster
મંદીર	Temple
વધ્યા	increased
બેસતી	sitting down
કરતું	Doing
છેતર્યા	cheated
કારીગરો	Artisans
ભણવા	To study
ભાવુક	emotional
ધરાવનારા	Possessing
જાદુ	Magic
પત્તું	Leaf
દયાબેન	Dayaben
ફોરવર્ડ	Forward
ઈંડસ્ટ્રીની	of the industry
સ્ક્રીન	Screen
મોબાઈલથી	From mobile
બિકિની	Bikini
કર્યું	done
કેદારનાથ’નું	'Kedarnath'
વઘુ	Vaghu
પેન	Pen
યુક્ત	yukta
વધવાના	To grow
દીપવીર	Deepveer
શિવગામીનો	Sivagami's
લાવ્યું	Brought in
મોનિકા	Monica
ખરીદનારાઓને	To buyers
સરકારઃ	Government:
કાર્તિક	Karthik
મોબાઈલમાંથી	From mobile
ફ્રિજ	fridge
બધાઇ	All of them
અપાવી	Given
અરબાઝ	Arbaaz
ઓપ્પો	Oppo
રોજગારી	Employment
લાઇનમાં	In line
કઠણ	firm
3000નો	Of 3000
કૈટરીના	Katrina
જશ્ન	Jashn
કર્મીની	of the worker
સૌમ્યા	Soumya
મહત્ત્વનો	Important
નહેવાલની	Nehwal's
કૈટરીનાનો	Katrina's
માર્યો	Killed
ડીઝલનાં	Of diesel
તું	You
પ્રચાર	Publicity
શૅરબજારમાં	In the stock market
સીટ	Seat
ઑફર	Offer
ઓક્ટોબરે	In October
એક્સચેન્જ	Exchange
ડૂંગળીના	Dungalina
મલાઇકાથી	From Malaika
એક્ટ્રેસિસનાં	Actresses
મેળવી	Received
ખતરામાં’	In danger'
ફતેહીએ	Fatehi
બેઝિસ	Bezis
વિચારશો	Think
વલસાડઃવેપારીઓ	Valsad: Traders
સ્પર્ધકને	to the contestant
મોહન	Mohan
વાળું	turning
જન્મદિવસની	Birthday
કેટલી	How much
મોબાઇલમાં	In mobile
જીવનસાથી	spouse
શર્મિલા	Sharmila
નેક્સનને	Nexon
અભિષેકનાં	Of Abhishek
વગર	without
જોવાની	To see
રાવ	Rao
સોદા	Deal
મનાવા	Manwa
રિલીઝ	Release
સમજાવશે	Will explain
વખતે	Time
સાજિદે	Sajid
પુત્ર	Son
સેક્સના	of sex
હોલિવૂડમાં	In Hollywood
સ્ક્રિન	Screen
વેચાય	Sold
માંગ્યું	Asked for
લીધે	Due to
બાર	Twelve
સરેન્ડર	Surrender
5ની	of 5
મોતની	of death
તનુશ્રીએ	Tanushree
ગ્રેચ્યુટીના	Gratuitya
સ્ટોરથી	From the store
હસીનાઓએ	Hasinao
ફરાર	Absconding
લેપટોપ	Laptop
અમદાવાદઃમ્યુનિ	Ahmedabad: Muni
પુનીત	Punit
ડેબિટ	Debit
લુંગી	Lungi
માનાં	Mana
વેપાર	Business
ચેટનું	of chat
શર્માનું	Sharma's
વડાલી	Wadali
ફાયદાનો	Benefits
ડોલર	Dollars
કાર્ડમાં	In the card
હેંગ	Heng
હેલો	Hello
સિકંદરના	Sikandar's
13મીએ	On the 13th
ગલીઓમાં	In the streets
અંકિતા	Ankita
રાજ્યોમાં	States
12નું	of 12
કોચરનો	Kochhar's
દેશમાં	in the country
ડ્રાઇવર	Driver
મિલાવશે	Will meet
ચાહકે	Fan
સારો	Good
શામેલ	Included
કાર્દિશિયન	Kardashian
લાવા	Lava
2018માં	In 2018
પાડશે	will
ભરતી	Recruitment
સેકન્ડમાં	in seconds
મોડો	Late
કહ્યુ	said
અરબાઝની	Arbaaz's
પૂરથી	from the flood
સુઝૈન	Suzanne
છુટાછેડાનાં	Divorce
માલદિવમાં	In the Maldives
બનાવનાર	Creator
ધક્કા	Push
ફરતા	Moving around
12માં	In 12th
મિસ્ટર	Mister
મિનીટમાં	In minutes
ઉડીને	Flying
કોચમાં	In the coach
ઘટાડીને	By reducing
યુએસ	U.S.
પાઉન્ડનું	of the pound
બેન્દ્રેની	Bendrenny
ફ્રાઇડે	Friday
વાર્તાલાપ	Conversation
ઇલિયાના	Ileana
હોલિડે	Holiday
બોયફ્રેન્ડના	boyfriend's
સ્વીકારે	Accepts
પ્રોમો	Promo
ચાબખો	Whip
સહેલાઈથી	Easily
પેપર	Paper
કુલ્હારી	Kulhari
પરિવહન	Transportation
ગાંધીને	To Gandhi
સવા	Sawa
હોસ્ટેલનું	of the hostel
જીજા	Jija
મોરચો	Front
રોકાણકારોએ	Investors
ચોર	thief
નિહાળી	Watched
ગ્લેમર્સ	Glamors
મહિનાનો	of the month
રણબીરના	Ranbir's
ઉલટા	On the contrary
શૂટિંગનાં	of shooting
સૌંદર્યા	Soundarya
હરિફ	Rival
માંગનાર	Asker
દરમાં	In rate
જણાવી	Tell me
સર્ચ	Search
કમરે	Kamre
કોમની	Of the community
પોકેટ	Pocket
વાપરનારા	User
બોન્ડિંગ	Bonding
ગીફ્ટ	Gift
ગાયોની	of cows
ફેબ્ર	Fabr
લીંક	Link
દોડતી	Running
છવાય	Chhaway
કુશલ	Kushal
દીપિકાનો	Of Deepika
હતી	was
દામ	Dam
વગરની	Without
ગણાવ્યું	Counted
ચંદન	Chandan
ડિવાઇસ	Device
હેડને	To Head
પાર્ટીના	Of the party
તાવ	fever
મિહિર	Mihir
બાસુએ	Basu
લોન્ચિંગ	Launching
અથવા	or
બેટી	Betty
અખિલેશને	To Akhilesh
પેમેન્ટ	Payment
કાતર	scissors
કંગના	Kangana
માન્યો	Believed
લાગી	It took
આમંત્રણ	Invitation
ખુલાસો	Explanation
કેરેટ	Caret
વાદમાં	In the debate
જૂથ	Group
મહિન્દ્રા	Mahindra
રંગીન	Colored
ભાઇનો	brother's
કચ્છમાં	in Kutch
ફેર	Fair
ફેટના	Fatna
નિધિ	Nidhi
નિતીન	Nitin
કાલા	Kaala
36માં	In 36
સમાવેશ	inclusion
થિએટ્રિકલ	Theatrical
ઉઠાવ્યો	Picked up
જેટલું	As much as
નફો	Profit
નરેન્દ્ર	Narendra
રિતિકને	To Hrithik
અભિનય	Acting
ઉરીઃ	Uri:
કાર્યવાહી	Proceedings
માર્ચમાં	in March
ધામી	Dhami
મસાબાએ	Masabae
રિયલ	Real
શોલે	Sholay
સંપૂર્ણપણે	absolutely
ખુશહાલ	Happy
ક્રિતિકાનો	Kritika's
નેતાઓને	Leaders
આવતીકાલે	Tomorrow
આદુવાળી	Ginger-walled
બદલો	Change
મિલરોને	To millers
છાત્રો	Students
પ્રિયંકાના	Priyanka's
જોરથી	Loudly
દાળની	of pulses
ફોલ્‍ડેબલ	Foldable
બનેલી	Made up
માહિતી	information
ઝડપાયો	Caught
માહિષ્મતીમાં	In Mahishmati
તારીખે	On the date
ભટ્ટે	Bhatte
દર્દીઓને	patients
વાણી	Speech
કાગડા’ને	'Kagda'
ડુંગળી	onion
લાકોની	Laconi
નાખીને	by pouring
કરવાનાં	To do
સત્તા	authority
અંગે	About
અને	and
બચશે	will survive
ટાંકીમાં	In tank
ચાલનારી	Walking
મલ્હોત્રા	Malhotra
બોલિવૂડમાં	In Bollywood
રોલમાં	In The Role
પિતાનો	Father's
માણસની	Man's
ખેંચી	Pulled
વહેંચે	Sharing
અશ્લીલ	Obscene
મોઢું	face
કંપનીનો	The company
બેજાન	Bejan
નોમુરા	Nomura
રણબીરની	Ranbir's
ઉઘોગમાં	in ughog
ખરીદી	buying
કિસ	Kiss
નાઇટમાં	At night
મામલામાં	In the case
2017માં	In 2017
ગર્લે	Girl
સીટી	CT
મોગલી	Mowgli
એક્સક્લૂઝિવ	Exclusive
જાણતા	Knew
યોજાઇ	Held
મુશ્કેલી	difficulty
માતાની	Mother's
તિવારી	Tiwari
વેસ્ટર્ન	Western
અમારી	our
અરજદારે	The petitioner
મસેજ	Massage
બિકિનીમાં	In a bikini
દુધ	Milk
સાંકડા	narrow
આદિત્ય	Aditya
ક્રિકેટર	Cricketer
નેશનલ	National
રહીશઃ	I will:
ખરેખર	Really
કો	Who
શીશી	Vial
પ્રકાશનું	of light
માન્યતા	Validation
ડિફોલ્ટર્સના	of defaulters
થયેલી	Done
ફોલો	Follow
000થી	From 000
લાલઘૂમ	Lalghum
તૈનાત	Deployed
સચ્ચાઇ	The Truth
જિંદગી	Life
ફિલ્મનું	The film
મેમરીવાળો	memoryable
કોમોલીકા	Comolica
હલી	Hallie
નંદિતા	Nandita
હાલમાં	Currently,
ચોરવાની	stealing
મોત	Death
પેપરની	of paper
શ્યાઓમી	Xiaomi
બનો	Be
લોનના	of the loan
પૉલિસીની	of the policy
રોશન	Roshan
લાવવાના	To fetch
જન્માષ્ટમીમાં	On Janmashtami
ભર્તી	Bharti
ધીમા	Slow
પડેલ	Fallen
સોનિયા	Sonia
મનાવો	Persuade
રિટર્ન્સ	Returns
નિકના	Nick's
બંધાયા	tied up
મોનાલિસાએ	Monalisa
આંકડા	Statistics
બોલવું	speak
ઉઠતાં	Getting up
વેલ્યું	Welly
જલોટાને	Jalotane
કમાણીને	earnings
કેટરિનાનો	Katrina's
આંખથી	with eyes
દિયર	Brother in Law
અપાશેઃનવો	Will be given:
બુરી	Buri
તૈમુર	Taimur
ખટરાગની	Khatragani
ભરૂચઃસસ્તુ	Bharuch: Sastu
વજાઇના	Vajaina
રાઝી	Razi
બીની	Beanie
યોગ	yoga
સ્કેમ	Scam
જોડાઇ	Connected
ઉચક્યો	raised
સ્માર્ટ્	Smart
બોલાવ્યા	Called
લિયોનીને	To Leoni
મિકા	Mika
ફ્લિપકાર્ટની	Flipkart's
દુધવાળો	Milkman
મસાન	Masaan
સમલૈંગિકતા	Homosexuality
રેમો	Remo
ટાઇગરની	Tiger's
બંધનમાં	In bonding
મળ્યાં	Met
ભણસાલીએ	Bhansali
વિજ્ઞાન	science
પડતો	falling
જયા	Jaya
લિગલ	Legal
બીમારીથી	from illness
મારપીટ	Beating
સ્વીટી	Sweety
જાનૈયાનું	Janaiah's
નંદા	Nanda
પ્રિયા	Priya
વર્ગમાં	in class
નુક્શાન	Damage
હરતા	Harta
એપીએમસી	APMC
રાજકોટઃદાગીના	Rajkot: Daagina
અમૃતા	Amrita
સપોર્ટસ	Supports
બંપ	Bump
8મી	8th
વિકાસ	development
કાઢી	Deleted
માલ્યાને	To Mallya
હતાઃ	They were:
લાયક	Eligible
વિપક્ષને	to the opposition
ખરાબ	bad
એક્ટરના	Of the actor
આફ્રિકા	Africa
પોઇન્ટનાં	points of
હોસ્ટ	Host
જેમા	In which
વિતાવ્યો	spent
અનંત	Infinite
ફની	Funny
એક્સીડેન્ટલ	Accidental
કાર્યભાર	Workload
ગમનો	Gum's
રોશનને	To Roshan
પેરાલિસિસ	Paralysis
જૈક્લીન	Jacqueline
સાચો	True
22મો	22nd
ગ્રામનો	Gram's
સ્કૂલ	School
મેક્સિસ	Maxis
જીવી	Living
તેમનું	Theirs
ડ્રોપમાં	in drop
ફેન્સે	Fans
મજાક	Joke
તૈયારી	preparation
અછતને	lack of
બજારોની	of the markets
બાળ	Child
સુનીલને	To Sunil
મહિલાઓનો	of women
મુદ્દતમાં	in term
નિર્દેશકોએ	Directors
સંગ્રહ	Storage
ડ્રાફ્ટ	Draft
સૂટમાં	in suit
રુપિયાથી	With rupees
ભાજપ	BJP
સ્પષ્ટીકરણ	Specification
પૈસાનો	of money
જીતુ	Jeetu
તરફેણ	Favors
વિડિયો	Video
કન્ટેસ્ટંટે	Contestant
એક્સરસાઇઝ	Exercise
કોઈપણ	Any
ઇચ્છાએ	at will
72થી	From 72
પોલીસી	Policy
ઓફરમાં	In offer
કતારમાં	In queue
ગ્રાહકોને	Customers
10125ની	10125
રણવિરનાં	Ranveer's
શેરબજાર	Stock Market
બદલશે	Will change
ટેબ્લેટ	Tablet
અંતિમ	Final
રા	Ra
હટી	Removed
સ્કૂટર	Scooter
અમેરિકાની	America's
સફળતા	Success
વિવાદમાં	In controversy
જેટલો	As much as
ફેરફારની	Changes
કેટરિનાનું	Katrina's
ફેમિલી	Family
છાણાં	Shades
તાતને	Tatne
ઉદ્યોગપતિઓના	of industrialists
રિલેશનશિપને	To the relationship
ચેમ્બર	Chamber
ગુજરાતને	To Gujarat
જ્વેલર્સની	Of jewellers
ડેઝી	Daisy
વાતો	Things
ધંધો	trade
ચૂંટણી	election
એમડીના	MD's
સંઘથી	from the Union
મહારાજાઓ	Maharajas
પહેલીવાર	For the first time
વચ્ચેથી	From the middle
અધિકાર	authority
હંકથી	From Hank
સર્વિસના	of service
નોકરીઓની	Of jobs
ચિદમ્બરમની	Chidambaram's
ભાવે	Price
શુભ	Good luck
મજુરોના	of the labourers
ઈનફિલ્ડને	To the infield
નિક	Nick
વજન	Weight
ફેમિલીની	of the family
ઇન્સ્યોરન્સ	Insurance
રેકોર્ડબ્રેક	Recordbreak
બેટ	island
ટોચના	Top
ઉઘતા	sleeping
બોલો	Speak up
અવિશ્વાસ	Distrust
નફરત	disgust
બરફનાં	Snow
સાંઘી	Sanghi
ચિંતામાં	In anxiety
મેળવવી	Getting
સહેલી	Easy
બંસલે	Bansal
દુબે	Dubey
ઝડપથી	Quickly
40000થી	From 40000
પાનેતર	Paneter
પ્રોગ્રામ	Program
6થી	From 6
હનિમૂનમાં	In honeymoon
મોનસૂન	Monsoon
એડવાન્સ	Advance
વિઠ્ઠલ	Vitthal
હિમ્મતવાલા	Himmatwala
વિરૂદ્ધ	against
વિજેતા	victor
ડિપાર્ટમેન્ટ	Department
બેન્કથી	from the bank
81માં	In 81
કપૂરનો	Kapoor's
લક્સ	Lux
રાખીનાં	Rakhina
રોકાણકારોને	To investors
ડિએક્ટિવ	Deactive
વાત	Talk
ચાલશે	Will go on
પાકિસ્તાની	Pakistani
અવતારથી	From avatar
શૂટિંગના	of shooting
આશ્ચર્ય	Surprise
ચેકિંગ	Checking
ગેંગરેપ	Gang rape
પહેરેલાં	worn
ગરીબ	meek
બેસીને	Sit down
સ્ક્રીનિંગ	Screening
ખાતા	Accounts
શશિ	Shashi
બદલાયું	Changed
પુલવામા	Pulwama
ફ્રિડમ	Freedom
વીજળીથી	by electricity
1હજાર	1,000
ખાતાથી	From account
110નો	Of 110
સગાઈનો	Of engagement
દેવને	To God
લાખોની	millions
કુંબલેએ	Kumble
કરોડોની	crores of rupees
રિલાયન્સ	Reliance
7ના	Of 7
રણવીરનો	Ranveer's
ચીફ	Chief
રોક	Rock
આગવા	Leading
વિવેક	Vivek
સ્ટાર્સના	of the stars
અશોક	Ashok
દારૂવાલાને	To the drunkards
બાહુબલી	Baahubali
ટીઝર	Teaser
તેજઃ	Tej:
સ્વામી	lord
છોડશે	will leave
ધબડકો	Banging
સેટ	Set
હસશો	Laugh
દત્તાએ	Datta
જાઉં	I'll go
જયના	Jayna
કારમાં	In the car
ડીઝલના	Diesel
55થી	From 55
કોઈની	Someone's
કરીનાનાં	Kareena's
હોટલમાં	in the hotel
લખેલા	Written
મનમાની	Arbitrary
નોઇડામાં	In Noida
ઉપાડવાનો	Lifting
ગા	Ga
ટેરિફ	Tariff
હેલિકોપ્ટર	Helicopters
ગેરફાયદા	Disadvantages
દીકરાએ	Son
આપને	You
સીઝનનું	of the season
પાદુકોણના	Of Padukone
પ્રીમિયમમાં	In premium
સેન્સર	Sensor
કપડાની	of clothes
કાર્ડનો	of the card
સીઈઓ	CEO
મચ્યો	Machyo
સપ્ટેમ્બરે	In September
ગીગા	Giga
દેવગણનો	Devgan's
ડિસેમ્બરે	December
સ્ક્રિનિંગમાં	In screening
છેતરપિંડીનાં	of fraud
4ને	4
બિલ્ડીંગોને	buildings
અખ્તરની	Akhtar's
રોયના	Royna
વેબસાઇટમાંથી	From the website
એન	N
રમતો	Games
વચ્ચેના	In between
ગુજરાતનું	Of Gujarat
આઉટફિટમાં	In an outfit
દૈનિક	Daily
તસવીરોઃ	Photos:
પહેરીને	By wearing
મુંબઈના	Mumbai
મોહક	Charming
નીતૂ	Neetu
વોલ	Wall
ટ્રેડિંગ	Trading
ઇન્ડસ્ટ્રીઝને	Industries
લાખોમાંથી	Out of millions
ચાંદ	The Moon
મિત્રોનું	of friends
ગાયું	Sung
બેઅસર	Unaffected
ફોડશો	Tear up
તૃતિયા	Tritiya
સ્વિમિંગપૂલમાં	in the swimming pool
જમાવ્યો	Fed
કોઈને	Someone
નિધન	Death
રાતે	At night
હોન્ડા	Honda
કરજો	Do it
જેઓ	Those who
ફ્રોડથી	From Fraud
રેડિએશન	Radiation
કોકરોચથી	From cockroaches
ટાઇપ	Type
અટકાયત	Detained
લાઇમલાઇટથી	From the limelight
ભરીને	Filled in
યથાવત્	As on
પરેશાનીમાં	In trouble
પેનલના	of the panel
અંદાજે	Approximately
દુરપયોગ	misuse
ભારતીયોની	Of The Indians
કરવુ	to do
કરોડનું	crores
નેહવાલની	Nehwal's
ગડકરી	Gadkari
ટ્રેજડી	Tragedy
ચેરપર્સન	Chairperson
દરરોજનાં	Every day
દાયરામાં	In daira
એફિડેવિટ	Affidavit
કરાર	Agreement
હેલ્થને	to health
ઇશિતાની	Ishita's
આરોપીઓ	accused
હટે	Move on
સુમુલ	Sumul
નગીના	Nagina
લગાવેલા	Installed
કિંમતે	At a price
બર્થ	Birth
રેસલર	Wrestler
મ્યૂઝિક	Music
ક્ષમતા	Capacity
સર્જીકલ	Surgical
વસુલી	Vasuli
મીલિયન	Milian
ડિવિઝનની	Of the Division
ગોવાના	Goa
સેશન	Session
લિયોનીનું	Of Leoni
કિશ્વર	Kishwer
જોવામાં	To see
કહેતો	saying
જેક્સન	Jackson
આપ્યુ	Given
સ્માર્ટફોનમાં	In the smartphone
મુશ્કેલ	difficult
કમળો	Orange
મુંબઇનાં	Of Mumbai
ટેક્સનો	of taxes
લખ્યુ	Written
શર્માએ	Sharma
ભારતના	Of India
સરળ	easy
બુરખો	Burkha
જોડિયા	Twins
સ્લિપમાં	In slip
એન્જિન	Engine
લિયોનની	Leon's
ખતરા	Danger
બટરફ્લાઇ	Butterfly
વર્કઆઉટ	Workout
299નો	Of 299
વિવાદિત	Disputed
ગિન્નીએ	Ginni
સંભાળવા	To handle
આટલું	So much
ફ્રીમેન	Freeman
રાજીનામાનું	resignation
બ્લાઉઝ	Blouse
પત્રમાં	In the letter
ઇટાલીમાં	In Italy
ચર્ચાયેલા	Discussed
ગ્રેસ	Grace
મનમોહક	Enchanting
ચશ્માથી	with glasses
એવોર્ડ	Awards
બનાસકાંઠામાં	In Banaskantha
ઘાઇના	Ghana
અજીમ	Azim
નાકાએ	Nakae
કંકોત્રીની	Of Kankotri
પ્રિયાનો	Priya's
નવાઝ	Nawaz
મિનિટથી	Minute by minute
મૂવી	Movie
ચોરાવવી	stealing
જીનિવામાં	In Geneva
સ્ટાફને	to the staff
સેન્ડલ	Sandals
કોન્ફરન્સમાં	at the conference
ચાંદલો	The moon
જાહ્નવીએ	Jahnavi
બેંકને	to the bank
દવેનું	Dave's
રેલનાં	of the railway
ઇ	e
લિસ્ટ	List
બેન્કોના	of the banks
કોલાબ્રેશન	Collaboration
નગ્ન	Naked
ઝલક	Glimpses
દિલ્હીના	Of Delhi
કોર્ટની	Court of Court
યામી	Yami
સરફરાઝે	Sarfraz
ભાજપમાંથી	from THE BJP
સોહાની	Sohani
ઇમ્પેક્ટ	Impact
ગણેશજીની	Of Ganeshji
ચૂક	Missed
કેનાલમાં	in the canal
ટ્રાન્સપરન્ટ	Transparent
આપોઃ	Give:
ક્રૃડ	Crude
વહુનો	daughter-in-law
ચેન્નઇમાં	in Chennai
બોગસ	bogus
બીલ	Bill
સંસદિય	Parliamentary
માહિકા	Mahika
ફિલ્મનાં	of the film
ટેક્ષ	Tax
પ્રી	Pre
પ્રેરણાની	of inspiration
જગ્યાઓ	Places
ટેકનોલોજીથી	With technology
દીપિકાના	Of Deepika
પ્રો	Pro
પ્લેબોય	Playboy
પકડી	Catch
નસીરુદ્દીન	Naseeruddin
બિમારી	Illness
દિવાળીના	Of Diwali
આઈટી	IT
નહિંતર	otherwise
વિશિષ્ટ	Specific
અર્જુન	Arjuna
રિફોર્મ	Reform
અન્યએ	others
પાર્ટી	Party
સોહેલ	Sohail
કલેકશન	Collection
સિંઘ	Singh
જાણવી	To know
ખાનનાં	Khan's
આદમીની	of the man
વેંચે	Sells
આકાશના	of the sky
એ્ક્સાઇઝના	Excise's
ત્રીજું	third
અમરેલીઃ	Amreli:
સ્માટફોન	Smatfon
હાઈકોર્ટે	High Court
આપશો	Give it
એપ્રિલ	April
ચોરે	The thief
સ્પિલટ્સવિલાની	Spiltsvillaney
નિકથી	From Nick
કંપનીનાં	Of the company
મહાબલેશ્વર	Mahabaleshwar
શૂન્ય	cipher
રંગો	Colors
બેચલરેટ	Bachelorette
સુરતના	Surat
સંગીતા	Sangeeta
આધારકાર્ડ	Aadhaar card
ગુડ	Good
સપ્ટેમ્બરથી	From September
કરોડો	Crores of
નીતિન	Nitin
હસિનાઓને	Hasinas
લાઈફ	Life
ટેનિસ	Tennis
અત્યાર	Now
ફરિયાદ	Complaint
ઓક્ટોબર	October
નીચલા	Lower
પહોળી	wide
લોન્ચિંગમાં	At launch
બર્થડેનાં	Birthday
સપ્તાહમાં	During the week
ઓપનિંગ	Opening
આઇ	I
થાઈલેંડ	Thailand
ઝી	Zee
ખોવાઇ	Lost
કપૂર	camphor
સાથેનું	With
ધારાસભ્ય	MLA
પાઠવી	Sent
ટ્રીકથી	From the trick
કૌશલની	Kaushal's
અપાવવાં	Giving
અસગરનો	Asghar's
પદ્માવતના	Of Padmavat
દર્શાવે	Displays
અસલી	Real
મિડનાઇટ	Midnight
ગ્રહણ	Eclipse
ઘટ્યું	decreased
સેલરી	Celery
શુદ્ધ	pure
થઈ	happened
જતા	Leaving
ડિમ્પલ	Dimple
દેશને	country
કોન્ફરન્સ	Conference
ઇન્સ્ટાગ્રામ	Instagram
યોજનાનું	of the scheme
દાસની	Dasni
આયોગની	Of the Commission
એટલાસ’આપનાર	Atlas' giver
માંગ્યા	Asked for
ગ્રૃપની	of the group
સ્માર્ટફોનની	of the smartphone
ખોલાવી	Opened
ટોક્સની	Tox's
એસ	S
વહૂનો	Of the wives
રણવિરનું	Ranveer's
રેસ્ટ	Rest
પ્રેક્ટિસનો	of practice
વિજળી	Electricity
દુઃખ	suffering
એને	To him
ફ્લાઇટમાં	In the flight
પહેર્યા	Wore
થવાને	to be
સ્ક્રિનની	of the screen
ઘટશે	will decrease
સેન	Sen
એકસરખી	The same
વેઈટિગ	Waiting
રૂવાળા	Ruwala
શર્મા	Sharma
જવાની	To go
આવીશ	Will come
લગાવવાની	To install
જગત	The World
વસૂલી	Recovery
દાના	Dana
કરોડની	crores
ઇન્શ્યોરન્સ	Insurance
કમાવવાની	Earning
ઇશાંતની	Ishant's
આવીરીતે	In this way
ઇકોનોમિનું	Of the Economy
દીધુ	Gave
હસિનાઓનો	Hasina's
રણધીરે	Randhir
ચેયરમેન	Chairman
વેચવાનો	To sell
ખાલી	Empty
વરસાદ	rain
ચેનલનો	Channel's
લહેંગો	Lehengas
શૂટિંગમાં	In the shooting
રિએક્શનથી	from the reaction
શાહિદ	Shahid
રસ્તા	Roads
સમન્સ	Summons
ઇન્ડસ્ટ્રીઝ	Industries
ગુપ્તાની	Gupta's
અભિનેત્રીએ	actress
સીટીને	To CT
કહે	Say
મેઘના	Meghna
વિચાર	thought
કરોડનો	crores
ઐશ્વર્યાનું	Of Aishwarya
80ને	80
ચેરમેને	Chairman
સ્કીમથી	from the scheme
અલન	Alan
જીગર	Jigar
સાયરસ	Cyrus
ફાટી	Burst
ભાભી	Sister-in-law
રેલવેએ	Railways
તેનુ	Of her
માસિક	monthly
સેન્સેક્સમાં	In the Sensex
આલિયાને	To Alia
ભાષણ	Speech
ચાર્જર	Charger
બેંકોમાંથી	from banks
બચાવીને	By saving
પ્રવેશવા	To log in
પોલીસકર્મીઓનું	of the policemen
અગામી	Agami
જાગી	Waking up
પાકુ	Paku
સનીની	Sunny's
એક્સચેંજ	Exchange
દિવસનો	of the day
બંધુઓ	Brothers
ઇન્દર	Inder
મોબાઈલની	Mobile's
બંધનું	Of closure
કસ્ટમ	Custom
ઓછામાં	At least
બેંકઃલઘુ	Bank: Laghu
બદનામીના	Of infamy
ક્લાક	Clock
ભજન	hymn
ગેમનાં	Of the game
લૂક	Look
શા	Why
ઇરાની	Irani
ખાદીની	of khadi
કૃષિ	Agriculture
ટ્વિસ્ટ	Twist
લિટર	Liter
બિચક	Bitchack
સંજુબાબા	Sanjubaba
ડિવોર્સ	Divorce
અપેક્ષાઓ	Expectations
મેમો	Memo
યુવાનોને	to the youth
વેચો	Sell
ડાંસિંગ	Dancing
માસ્ટરબેશનના	of masterbation
જાણવું	To know
મિલિયન	million
કાળા	Black
ફરવાનો	Walking around
બિન્ની	Binny
સમર્થન	Support
બેલ્ઝિયમથી	From Belgium
ફાધર્સ	Fathers
સંજય	Sanjay
ઉંઘ	Sleep
ડેલીગેશન	Delegation
લેવિશ	Levish
કેટરિનાની	Katrina's
ઇડર	Idar
કૉફી	coffee
ગુજરાતીની	Of Gujarati
ઇયરફોન	Earphones
આવી	Such as
મૂળ	origin
પાડોશીએ	Neighbor
યોજ્યું	Held
ટૂંકો	Short
શીખ	Learn
આવે	Come on
કડડભૂસ	Kadadbhus
સોનલ	Sonal
અડધો	Half
અવરામનું	Avram's
પુરી	Puri
વાવીને	by sowing
સબ્સટેન્સ	Substansion
ફેસબુકની	Facebook's
પેઇન	Paine
સુસ્મિતાની	Sushmita's
અભિષેક	Abhishek
કૌશલનાં	Kaushal's
વેબ	Web
એશિયા	Asia
અંબાણીના	Ambani's
ઇન્ડસ્ટ્રીની	of the industry
ચિટ્ઠી	Chitthi
એલાન	Alan
પોલીસ	The police
થાળી	plate
રહી	stayed
સુપીરિયર	Superior
ડ્રિંક	Drink
બોલવાથી	By speaking
બટરફ્લાય	Butterfly
સિલિન્ડર	Cylinder
ગુરૂમંત્ર	Gurumantra
બાકીના	The rest
ભાટકરનું	Bhatkar's
અવમાનનાના	of contempt
કન્ટેઇન્ટ	Content
શાહની	Shahni
ઉઘરાણાથી	from Ughrana
રડાવ્યાઃપોષણક્ષમ	Crying: nourishable
પરેશાન	Upset
નોટિસ	Notice
એકદમ	Absolutely
સટીક	Accurate
બેલી	Bailey
બાહુબલી’ની	'Baahubali'
રાત	Night
લેવાની	To take
જોઈને	Looking at
મોંઢું	mouthful
અંબાણીનો	Ambani's
મોહી	Mohi
સાલેમની	Salem's
પત્નીની	wife's
જ્હોન	John
કરિના	Kareena
નકલ	Copy
માસમાં	in months
પ્લાનને	to the plan
કહેનારી	Teller
ગોપી	Gopi
હિમેશ	Himesh
ટિકિટને	To ticket
મોડ	Mode
સેનને	Senne
ફરીયાદ	Complaint
ધોવાયો	Washed
13માર્ચથી	From March 13
થયો	Happened
રેર	Rare
તૂ્ટ્યા	Tutya
ભણાવી	Teaching
લત	Addiction
શક્યો	could
રાજ્યનો	of the state
પોલિસીની	of the policy
તોડવા	To break
દીકરી	Daughter
દેખાડ્યું	Shown
ખબર	I know
જીસ્વાનની	Jiswan's
ભૂમિની	of the land
કોહલીનો	Kohli's
છૂપાઈને	in hiding
ફતેહ	Fateh
ઉપડ્યા	flew
ઔષધી	medicine
ડિલેવરી	Delivery
બેગનો	of the bag
પ્રોપર્ટીના	of the property
મોઘું	Expensive
દિગ્ગજ	Veteran
કથક	Kathak
વધારશે	Will increase
ઝંઝટથી	From the hassle
જેનિફરે	Jennifer
આવું	Such is the case
રંગભેદનો	Racism
ટ્રેક	Track
મોંઘવારીનો	of inflation
સાબુનો	of soap
સીલ	Seal
બદલાવનારના	of the changer
બેસ્ટ	Best
છોકરીઓ	Girls
સુષમાએ	Sushma
મજબૂરીમાં	forced to
ગડકરીએ	Gadkari
ખર્ચો	Expenses
ઈન્ટરનેટની	of the Internet
કાદર	Kader
પંથે	Panthe
અમદાવાદનો	Of Ahmedabad
પંજાબ	Punjab
પોલિસીમાં	in policy
ફોનમાંથી	From the phone
કોર્ટ	Court
ફેલ	Failed
ભાઈજાન	Bhaijaan
સ્પોર્ટ્સ	Sports
ચલાવો	Run
કિંમત	price
મહિલાઓની	women's
એટીએમમાં	In THE ATM
આમના	Aamna
અભિનેત્રીઓને	To actresses
પ્રવાસની	Of the trip
મારધાડ	Mardhad
મેમ્બરશીપ	Membership
દિવસે	By day
શાખાઓમાં	In branches
કેમ	how
આરાધ્યા	Aaradhya
દર્શકો	Viewers
ફરશે	Will rotate
લાખથી	Lakh
સુરત	Surat
તારીખ	date
વેચવાનું	To sell
પહેર્યો	Wore
આયુષ્માન	Ayushman
પરીણિતીના	Of the marriage
બંધાશે	will be tied
કારણથી	Because
એન્ડ્રોયડ	Android
કિરણ	Rays
જોબ્સની	Jobs
બાદ	Afterwards
મોદીની	Modi's
ભાવ	rate
વધારતા	Increasing
શિયોમીના	Xiaomina
વર્લી	Worli
ફૂટબોલ	Football
એક્ટ્રેસનાં	Of the actress
સંદેશ	Message
રીમિક્સ	Remix
પરમિશન	Permission
પપ્પાએ	Dad
છુટકારો	Get rid of
ખતરાને	the danger
ઓસ્ટ્રેલિયા	Australia
ભરપેટ	Filled up
અંડરવર્લ્ડ	Underworld
હડતાલ	Strike
એક્ટરનો	of the actor
રિયાએ	Riya
અંદર	Inside
ડાયમંડ	Diamond Diamond
દિકરીના	daughter's
શેરબજારના	Of the stock market
મત	Vote
સમિતિ	committee
લઇશ’	I'll take it."
ભૈયાની	Bhaiyyani
વારો	Turn
મદ્રાસ	Madras
ઓફિસથી	From the office
ફોનને	to the phone
વિદેશમાં	Abroad
મરી	Mary
કોલેજ	College
પોઇન્ટ	Points
સિંહ	lion
રણવીરે	Ranveer
કારખાનાઓ	Factories
આવુ	Such
ઉદ્યોગોને	To industries
અંડરવિયર	Underwear
પદ્મિની	Padmini
લીગલ	Legal
ચલણમાં	in currency
ખરીદીની	Purchase
ક્લીક	Cliq
રેટ્સ	Rates
તસ્વીરો	Photos
પગલાં	Steps
દિન	Day
દિકરી	daughter
તનુશ્રીનાં	Tanushree's
નાગરિકોને	citizens
ફેક્ટરીઓને	to factories
બેડરૂમ	Bedroom
કિડ્સ	Kids
ભાઈની	brother's
ઉત્સાહ	Enthusiasm
ગણી	Counting
નુકસાનકારક	harmful
સમારંભમાં	At the ceremony
ઇરફાનની	Irfan's
ખેરે	Kheere
રોકોર્ડિંગ	Rocording
વચન	Promise
કેમેરામાં	In camera
ઈન્ટરનેટ	Internet
અનુરાગના	Anurag's
વ્યક્તિ	individual
રૂમમાં	in the room
7માં	7th
હસીનાઓની	Of the hasinas
ઝીંકી	Zinky
સુશાંતનાં	Sushant's
ઠાકરેની	Thackeray's
પ્રોપ્રટી	Proprie
ફાર્માના	Pharma's
મચાવશે	Will create
અંડરવોટર	Underwater
જોડાયેલ	Connected
ગૌરી	Gauri
બેંકિંગથી	From banking
ફેન્સ	Fans
ભથ્થામાં	in allowance
લાગતી	Seems like
ઓછું	deficient
અપનાવ્યો	Adopted
તંગીને	to the crisis
કામથી	from work
ગીતથી	From song
ગાંધીજીની	Of Gandhiji
એડિટરને	To the Editor
વિદ્યાર્થીઓને	To the students
પાર્થની	Parthni
ફિચર	Feature
દિલબર	Dilbar
ઉડાન	Flying
વિંગ	Wing
બોલિવૂડના	Bollywood
વાર્ષિક	Annually
મેનુ	Menu
સેનનું	Sen's
પુરા	Full
અટલજીનાં	Atalji's
21000માં	In 21000
બહેનની	sister's
કોમેડિયન	Comedian
બનાવ્યું	Created
સ્પોર્ટસે	Sports
શુદ્ધતાની	of purity
15મી	15th
ટ્રાફિકના	of traffic
કાનૂની	Legal
ફ્લોપ	Flop
સાક્ષી	witness
જોર્જિયા	Georgia
ઘણું	Too much
બદલ	Change
ડિઝાઇનર	Designer
પીએમ	PM
મફતમાં	For free
પર્ફોમન્સ	Performance
ઔદ્યોગિક	Industrial
શાહરૂખે	Shah Rukh
બેકાબૂ	uncontrollable
દ્વારા	by
દિવસીય	Day
એવોર્ડથી	From the award
કેર	Care
હિરાનીની	Hirani
વિજય	Victory
ન્યૂરોએન્ડોક્રાઇન	Neuroendocrine
બીમારીની	of illness
માધ્યમથી	by means
ફિલ્મના	Of the film
આલોકનાથની	AlokNath's
ચલાવતી	Running
જઇને	Go and
બહૂએ	Bahuye
ઉંચકાયા	Lifted up
કરતો	doing
વર્ષના	of the year
અકસ્માતમાં	In an accident
ગીતોની	Of Songs
હાજર	Present
ગમે	Anyhow
નખરાં	nails
જોયું	Saw
ઇફેક્ટઃશાકભાજીના	Effect: Vegetables
વિનરનો	Winner's
બંગ્લો	Bungalows
સંપર્ક	Contact
મ્યુઝિયમ	Museum
ફરહાન	Farhan
મોટી	Big
અવગણસો	Ignore
10હજારથી	From 10,000
અડધી	Half
સન્નાટો	Sannato
ફોલ્ડેબલ	Foldable
બેંક	bank
ફરીથી	Again
જાહેરાત	Advertising
અપાયા	Given
જાહેરાતના	Of advertising
તનુશ્રીનો	Tanushree's
ગોટાળો	Scam
વળતો	Turning back
ઇન્ટરનેટની	of the Internet
બેંકકર્મી	Bank employees
સાવઘાન	Sawghan
પૌત્રીએ	granddaughter
કોપી’	copy'
છોડ્યુ	Dropped
કરોડોનો	of crores
હજારમાં	in thousands
અભિનેત્રી	Actress
રાહતઃ	Relief:
ટોપલેસ	Topless
દરિયાઇ	Marine
બેકારી	Unemployment
સ્કુટરમાંથી	From the scooter
તેટલું	As much as
બ્રાન્ડે	Brande
શોનો	Of the show
પડાવેલી	dropped
ઉઠ્યો	got up
ઉઘડતા	bouncing
પુનીશ	Puneesh
પેજ	Page
ચૂકાદો	Verdict
ઝાટકી	Jhatki
પ્રકાશ	light
વાસ્તવિક	Real
કમિશનરે	The Commissioner
એડ	Ed
વૈષ્ણોદેવી	Vaishnodevi
આવક	Income
હિચકી	Hichki
જુલાઈએ	In July
ક્યોકી	Kyoki
અ	A
ઇમાનદારી	Honesty
કેરળનાં	Of Kerala
તંગી	shortage
ફિંગરપ્રિન્ટ	Fingerprint
દત્તનાં	Dutt's
લાભોની	Benefits
થપ્પડ	slap
સારી	Good
રાજા	king
દુલ્હો	Brides
મંગેતર	Fiancée
ભારતમા	In India
માંગતા	Want to
ઘસીને	By dragging
ચાલૂ	Let's go
ઘરબેઠા	sitting at home
તેલુગૂ	Telugu
છુપાવ્યું	Hidden
ક્વોલિટી	Quality
નેહાની	Neha's
સંભળાવી	Listening
કાળજી	Care
વાળો	Turn
ઘંઉના	Wheat
રિચાર્જ	Recharge
નિર્માતાને	to the producer
કેમેરાવાળા	Camera-ridden
પ્રોડક્ટસ	Products
ગાંધીનગર	Gandhinagar
ચૂકવી	Paid
જન્મદિનને	Birthday
મૌની	Mouni
શરમથી	out of shame
ધનિકો	The rich
નાનપણમાં	As a child
અરબાઝે	Arbaaz
ઘર	House
હરાજી	auction
એરલાઈન્સ	Airlines
અરજી	request
લોખંડેનો	Iron
ગુંડાઓ	goons
મશિન	Machine
બેંકનું	of the bank
જાવ	Go
બોસમાં	In the boss
ધમકી	Threats
છીનવાઇ	snatched away
પ્રોડ્યુસરને	To the producer
અપરાધી	Criminal
ત્યા	There
છોડે	Leaving
ચાવલા	Chawla
વિજ્યા	Vijaya
રેલવેની	Of the Railways
ઉધારમાં	In borrowing
મોંધુ	Expensive
મહિન્દ્રાની	Mahindra's
કંગનાનો	Kangana's
ખેડૂતોએ	Farmers
અધિકારી	Officer
આપવાનું	To give
બીડી	Beedi
10550ની	10550
ભારતીયોના	of Indians
હૈ	Hai
ખરાઇ	True
સ્ટોર્સની	of stores
લેવાલીથી	From Levali
દુબઈમાંથી	from Dubai
મિલકત	Property
મનપસંદનું	Of favorites
પડતાં	falling
બેરોજગાર	Unemployed
ટાઇગરનું	Tiger's
પેટ્રોલની	of petrol
રઝા	Raza
અસંસ્કારી	Uncultured
ધારકો	Holders
સિંગલ	Single
નેશન	Nation
યુવતીઓને	To the girls
સસ્તાં	Cheap
સુહેલ	Suhel
જસલીને	Jasleen
ગલ્લી	Gully
ઠપ	Slap
કોન્ટ્રાક્ટ	Contract
એક્ટ્રેસિસ	Actresses
નોકરીઓને	To jobs
દારૂ	liquor
ખુલ્યું	Opened
શ્વેતાએ	Shweta
દુલ્હનિયા	Bride's
રેલ્વેમાં	In railways
સિધ્ધિ	Achievement
દસ્તૂરનો	Dastur's
કોકપીટ	Cockpit
ઇન્કમટેક્ષ	IncomeTax
યોદ્ધા	Warrior
પ્રોજેક્ટનું	of the project
બંદરે	At the port
લાઇક	Like
મારશે	will kill
ઓડીટ	Audit
સ્પેશ્યલ	Special
સુતા	Suta
એજન્સીઓ	Agencies
આઈસીઆઈસીઆઈ	ICICI
મધુ	honey
વર્ષ	year
જોયુ	See
ઝરીન	Zareen
બચાવવા	To save
હિસ્સો	Part
બચ્ચનને	To Bachchan
ચોપારા	Chopara
ઝડપાઇ	Caught
અપાશે	Will be given
વધશે	will increase
નીચી	Low
24મી	24th
વધામણા	Congratulations
પાકિસ્તાનનાં	of Pakistan
યુગમાં	in the era
ચેતક	Chetak
શ્રિયા	Shriya
મંદી	recession
પોઈન્ટનો	of points
મરચાના	Chili
બચ્ચને	Bachchan
શેખે	Sheikhe
ભારતીયના	Of Indian
શબ્દોનો	Words
ઠાલવ્યો	dumped
ફોર્બ્સની	Of Forbes
દિલ્હી	Delhi
સાસુનો	Mother-in-law's
બોલીવુડની	Of Bollywood
ને	and
લીલી	Green
શિખવાડનારી	Teacher
ઇંધણના	of fuel
પહેરાવાયો	worn
યુ	U
દાવપેચમાં	In the bargain
ગઈ	Gone
સ્કિમ	Skim
દંગ	Daang
યૂટ્યૂબ	YouTube
ચિત્રાંગદાએ	Chitrangada
બિલ્ડિંગ	Building
દોષી	guilty
રિબન	Ribbon
જેલના	Jail
એજન્ડા	Agenda
છૂપાઇને	by hiding
મેળવનારી	Recipient
રોજ	Every day
આનો	of this
પંડ્યાને	To Pandya
તસવીરથી	From the picture
મુલાકાતમાં	At the visit
શત્રુઘ્ન	Enemy
તેમના	their
તક	Chance
રાતોરાત	Overnight
ગોરખધંધાનો	Of the business of gorakh
મસ્તીથી	with fun
વધારાયું	Extras
ચુપચાપ	Quietly
મહેમાન	guest
હેડન	Hayden
અભિનેતા	Actor
વરરાજા	The groom
યુવતીઓ	Girls
ચર્ચાનો	Of discussion
કૃતિ	Kriti
આગળ	ahead
વધાર્યો	increased
હચમાવી	Shaking
કરશે	Will do
મારૂતિ	Maruti
ડિરેક્ટરને	To the Director
જોધપુરમાં	in Jodhpur
ચોથ	Fourth
કોચરે	Kochhare
ઘોડેસવારી	horse-riding
મહેનતની	Hard work
વીખેરી	Scattered
શાહરૂખને	To Shah Rukh
ટાઇગરે	Tiger
લંબાવવું	Prolonging
સેલ્ફી	Selfie
સરફરોશ	Sarfarosh
નમ	Nam
રોકાણ	Investment
સૌરાષ્ટ્રમાં	In Saurashtra
કૈલાશ	Kailash
સોદો	Deal
રેસલરે	Wrestler
જ્હાનવીએ	Jahnvi
જૈનને	To Jain
ગેસના	of gas
ઘમંડ	Pride
માઇલેજ	Mileage
સરકારને	To the Government
ઈચક	Ichak
તૈયારીઓ	Preparations
રખાયું	kept
બર્થડે	Birthday
સંબંધી	Relative
હોંશ	Honsh
ટ્યૂબરની	of the tuber
ડીવીજનની	of division
દાદીએ	Grandma
ગુજ્જુ	Gujju
સૌને	To everyone
બલવંત	Balwant
સિટી	City
જીતવા	To win
પ્રસિદ્ધિ	Publicity
કપિલનાં	Kapil's
ટ્રોલિંગનો	of trolling
ઊંચી	High
દિલીપ	Dilip
ત્રણની	of three
છોડવાનું	Quitting
ચુકવણું	Payment
ચક્કર	Dizziness
લિમિટ	Limit
આયુષ્માનની	Ayushman's
ખામી	Error
લૂઝર	Loser
34હજાર	34,000
ફોલોઅર્સ	Followers
પેપરલેસ	Paperless
દેવા	Deva
પેટ્રેલ	Petrel
અખ્તરે	Akhtar
નિભાવશે	Will play
ખોલો	Open
સ્ટાઇલિશ	stylish
ખુદરા	Khudra
74ને	74
શૂટિંગ	Shooting
છપ્પાક	Chhapaak
માર્ટિન	Martin
ચૂકેલી	Missed
વેચાયું	Sold out
પોસ્ટ્સ	Posts
અધધ	half
રજૂઆત	Presentation
વીર	Veer
ભટ્ટના	Bhatt's
સ્ટાર	Star
શ્રોફ	Shroff
કોમોલિકા	Komolika
ગરીબો	Poor
સૌરભ	Saurabh
શેરમાં	in shares
સ્પાઇડરમેન	Spiderman
મેગેઝિને	magazine
કાર્ડને	to the card
અર્થ	meaning
શૂઝ	Shoes
સિદ્દિકીની	Siddiqui's
વિરૂષ્કા	Virushka
મુંબઇમાં	In Mumbai
પહોંચાડ્યો	Delivered
તેડું	That's
બચ્ચન	Bachchan
પાથર્યા	Pathraya
સિંબા	Simba
ચુડેલ	Chudel
સવારી	Ride
જય	Jay
બૈઠે	Baithe
ઓછો	Less
યુટ્યૂબ	YouTube
ભૂલવા	To Forget
છિલ્લરનો	Chhillar's
ઇશારો	Gestures
સલીમ	Salim
આવતીકાલથી	From tomorrow
વિસ્ફોટકોની	of explosives
કંઇક	Something
એકટ્રેસનું	of the actress
નોટબંધીથી	From demonetisation
કરનારની	of the doer
કોઇપણ	Any
ખાં	Khan
સ્ટેટ્સ	States
રાખી	Rakhi
અકાઉન્ટ	Accounts
પનામા	Panama
પ્લસનો	Pluso
ક્રિકેટરનું	Of the cricketer
થનાર	To be
એપ્સને	To the apps
આપકા	Yours
ઉઠશે	will get up
શ્લોકાની	Shloka's
ખેચે	Kheche
ભૂત	Ghost
વિભાગનો	Of the section
ગળે	Hug
ઑક્ટોબર	October
મોટોરોલા	Motorola
બીજાને	to others
મનાવ્યો	Celebrated
વેચાણને	To Sell
કોંગ્રેસી	Congressmen
કોમેડી	Comedy
લેશો	Take it
ડીઝલમાં	In diesel
ઇજા	Injury
દેવાનો	Debt
પહેલાથી	Already
આમ્રપાલી	Amrapali
સ્વદેશી	Swadeshi
હિંદીમાં	In Hindi
ઉલ્લંઘન	Violation
પોપ્યુલર	Popular
ઓ	O
10450ની	10450
વિંટીનો	Vintino
ખોલશે	Will Open
ઓમ	Om
પ્રભાસે	Prabhase
ઉતારી	Offloaded
વિતે	Vite
આશિકી	Aashiqui
જેટલીએ	Jaitley
ચોટલાથી	From Chotala
કેમેસ્ટ્રીનો	Of Chemistry
ફક્ત	Only
રણવિરનો	Ranveer's
ડૂબેલી	Drowned
હાર્વર્ડમાં	At Harvard
મહિલા	Women
આત્મહત્યાનાં	of suicide
બજારોમાં	in the markets
જોર	force
હાઉસફૂલ	Housefull
જયમાલા	Jayamala
સ્માર્ટફોનમાંથી	From the smartphone
રાજ્યમાં	in the state
હોમલોન	Homelon
જેટલી	Jaitley
શિવસેનાનો	Shiv Sena's
ટંડના	Tandana
પોતાનું	own
લાખનું	of lakhs
15000નું	Of 15000
ધવન	Dhawan
દાસનાં	Dasna
સિંહા	Sinha
ડ્રાઇવિંગ	Driving
સાચી	True
બચાઓ	Save
રાજૂ	Raju
અપટેડ	Upted
ખુલ્લી	Open
ઉજવી	Celebrating
કિલોમીટરનો	Kilometers
ડિસ્પ્લેમાં	In display
ઝિંદગી	Life
રાવનો	Rao's
સ્કેલ	Scale
ઇટીવીના	ETV's
સ્ટાર્ચના	Starchna
ઢળતો	Falling
એક્ટ્રેસે	The actress
વિદેશયાત્રા	Travel abroad
ઓકટોબરથી	From October
સ્ટાઇલિસ્ટની	of the stylist
તેજીનો	Boom
ગણતરી	count
ગૂગલના	Of Google
માફી	Apologies
તેજીના	Tejina
899માં	In 899
જીવ	life
કરેલો	Done
લોંચઃ	Launch:
શકતા	could
આન્ટી	Aunty
વોરિયરની	Warrior's
ઘરબેઠે	at home
ખૂબસુરત	Beautiful
એયર	Iyer
બનાવશે	Created
બેંકમાંથી	from the bank
લીધી	Taken
સ્વિકાર્યુ	accepted
પૈસો	money
લેક્મે	Lakme
વિધાનસભા	Legislative Assembly
એવોર્ડ્સનાં	Awards
ફિલ્ટર	Filter
બેઠો	Sat down
મોકલનારની	of the sender
શહીદોના	of the martyrs
લગાડી	Lagi
સુનિલ	Sunil
ભત્રીજીને	to the niece
મંદીમાં	In recession
પાયલોટોની	Of pilots
ચાર્ટ	Chart
શાહરુખની	Shah Rukh's
આટલો	So much
સીસીટીવી	CCTV
મટકાવીને	Matkave
પ્રોસ્ટીટ્યૂટ	Prostitune
મિત્તલ	Mittal
ચોપડાનું	Chopra's
હેડલાઈન	Headline
3જા	3ja
જોન્સ	Jones
જોનસનાં	Of Jonas
નિષ્ફળ	Failed
દિવાનો	Divas
દવાઓનાં	of medicines
યૂજર્સને	To users
જગબંધુએ	Jagabandhu
ફટકાર્યા	hit
હદ	Range
ચુકેલા	have already
જોનારાને	To the viewer
દર્શકોની	of the audience
ખોલવા	Open up
ઇન્ડસ્ટ્રીમાં	in the industry
કરીમીએ	Karimi
ગાડીના	of the car
ચલાવે	Runs
વાતમાં	In the talk
નંબર	Number
દુકાનથી	From the shop
ફોર્ટિસના	Fortis'
શિલ્પાએ	Shilpa
વધારાનો	Extra
સેલિબ્રિટીઝનો	Of celebrities
દૂધનો	of milk
વાગે	It's time
સ્કિનીંગમાં	In scanning
280એ	280A
પૂછાયેલા	Asked
ઇન્દોરથી	From Indore
ભવિષ્યમાં	In the future
વિતાવવા	To spend
ફીદા	Fida
લક્ઝરી	Luxury
રુહીએ	Ruhie
બાહુબલી’નો	'Baahubali'
મારપાટી	Marpati
કરાવેલી	Done
કંપનીમાં	In the company
વરસાવ્યો	Rained
તેમનાં	Theirs
ઉબર	Uber
જીડીપી	GDP
ખોટું	bad
ચોપરાનો	Chopra's
રકમને	To The Amount
બકવાસ	Nonsense
અનુષ્કાની	Anushka's
જેક	Jack
ગોલી	Goli
નોટબંધીના	of demonetisation
ભણસાળીની	Bhansali's
ઈશા	Isha
બ્લોક	Block
સેલિબ્રિટીઝે	Celebrities
ખુબ	A lot
ચાલકનું	of the driver
આપવા	to give
ઠગ	Thugs
પંખાનો	Of the fan
સોરેન્સનનું	Sorenson's
ડીલથી	From the deal
બેન્કે	Bank
વજનથી	by weight
કેટલુ	How much
પાનથી	From the page
જાણો	Know
શોધી	Search
ટાઉન	Town
સપ્ટેમ્બર	September
અટકાવ્યું	Paused
લગાવ્યાં	Installed
વેનેઝુએલા	Venezuela
રણબિર	Ranbir
સાવંતે	Savante
પોસ્ટઑફિસમાં	in the post office
ડબ્બુ	Dabboo
નિદાહસ	Nidahas
માલ્યા	Mallya
સવાલોમાં	in questions
પાર્ક	Park
બદલે	instead
લેશે	will take
પમ્પ	Pump
કિંમતમાં	In Price
સેલિબ્રિટીઝને	To celebrities
રનોત	Ranot
પીએચ	PH
સંયોગ	Coincidence
ઇંતઝાર	Intazar
ઇરાન	Iran
જેનેરિક	Generic
સહાય	Help
મુજશે	Mujeshe
રોજના	Daily
જેના	whose
કચ્છની	Of Kachchh
ચોક્કસ	Definitely
2નો	of 2
આપ	You
ગ્રાહકે	The customer
હોલિવૂડ	Hollywood
વિસર્જન	Dissolution
ગોયલ	Goyal
એપ્લિકેશનનો	of the app
છપાય	Printed
સંજયને	To Sanjay
દાજ્યા	Dajya
બ્રેકિંગ	Braking
પૂરુ	Puru
પોસ્ટર્સ	Posters
ઘટ્યાં	decreased
નોટ	Note
છૂટાછેડા	Divorce
અંડમાનમાં	In the Andamans
ઉઠે	Get up
સેના	force
ગોડાઉન	Warehouse
હજુ	Still
દેવગણે	Devgan
સોમનાથના	Of Somnath
વિતાવી	Spent
રેફ્યૂજી	Refugee
દિશાનો	Direction
આજે	Today
બનવાના	to become
નિકાસ	Export
ઇન્ટરવ્યૂ	Interview
દોડશે	Will run
બિલ્ડીંગ	Building
દીકરીનો	of the daughter
મલાઇકાનું	Malaika's
જોહર	Johar
લોનની	of the loan
વેનેઝુએલાની	Of Venezuela
પ્રૂફની	Proofney
અપાઇ	Given
વાંચશો	Read
દિકરીએ	the daughter
હટ	Hatt
બાહુબલીને	To Baahubali
સ્થાન	place
શેટ્ટીની	Shetty's
ફ્રીમાં	For free
મીઠો	Sweet
કાર્યકરોની	of the workers
શમાએ	Shama
રેલવેમાં	In railways
ચા	tea
ભટ્ટનાં	Bhatt's
માર્કેટિંગ’નો	Of 'Marketing'
પતિ	Husband
પેઢી	generation
પોંસ	Pons
30મી	30th
જોડાણ	Connection
ઓફર	Offer
બુટ	Boot
બેલા	Bella
ડ્રાઇવરને	to the driver
ચોરીથી	by stealing
જાહેરાતની	Advertising
કિંમતો	Values
યાર્ડના	Yard's
કબૂલ્યું	admitted
યુવા	young
શોષણ	Absorption
લેભાગુઓથી	From Lebhaguo
નવાં	New
ફેસબુક	Facebook
ઉડ્યા	flew
સરપ્રાઈઝ	Surprise
જ્યારે	When
ખેડૂતોની	Farmers
ચોંકાવનારો	Shocking
સુંદરતામાં	in beauty
અમાન્ડાની	Amanda's
સસ્તું	cheap
બિગ	Big
ઉર્વશી	Urvashi
બ્રેગ્ઝિટની	Braggit's
વિચારો	Think
ધર્મશાલામાં	in Dharamshala
નામથી	By name
જવેલર્સોનું	Of jewelers
સિંઘને	To Singh
ટ્રીક	Trick
3માં	In 3
ગુસ્સે	Angry
ડરે	Afraid
પાડ્યો	Dropped
ડાન્સે	Dance
કેસર	saffron
બૅન્કો	Banks
સિટીઝન	Citizen
કાળાનાણા	Black money
હોલીવુડની	Of Hollywood
પત્નીને	To the wife
ઉપર	Above
સારથી	Sarathi
સરણી	Sarani
પેપર્સ	Papers
અર્ચનાનું	Of Archana
સ્માઇલ	Smile
રતનાનીનું	Ratnani's
એન્ટિલિયાની	Antilliani
ટર્નઓવર	Turnover
શીખી	Learned
બોડી	Body
જયપુરમાં	In Jaipur
બ્લાસ્ટ	Blast
સુરક્ષિત	secure
પ્રભાષ	Speech
સિગારેટ	cigarette
ભાવને	To Price
ભાઈજાનને	To bhaijaan
બેકિંગ	Baking
જુની	Old
કેમેરા	Camera
ધનતેરસે	Dhanteras
સિક્રેટ	Secret
ખુલી	Open
ઈટાલીના	Of Italy
સ્લિમ	Slim
ફાસ્ટ	Fast
પદ્માવત	Padmavat
ચોકાવનારી	Shocking
હાથો	Hands
રહેશે	will remain
ફ્લેશ	Flash
સેવી	Savvy
જહાન્સીએ	Jahansi
ડાયરેક્ટરની	Director's
કેનેડાને	To Canada
અમિતાભનું	Amitabh's
ફ્લર્ટિંગથી	From flirting
જગ્યા	place
ડિલિવરી	Delivery
અભિનંદન	Congratulations
મુકાબલો	Match
શિંદેના	Shinde's
કેમેરાનો	of the camera
લગાવાશે	will be installed
ઉંચાઇવાળી	high-altitude
પરિણામ	consequence
મૌનીનો	Mouni's
મશહુર	Mashhoor
લુક	Look
મીલાવશે	Will meet
ખાતામાંથી	from the account
સેવિંગ	Saving
માર્ચથી	From March
મશીનો	Machines
હોસ્પિટલમાંથી	from the hospital
રિક્ષા	Rickshaw
ખાનની	Khan's
400ને	To 400
યુનિફોર્મ	Uniform
ખુશીએ	Happily
ન્યાયતંત્રનો	of the judiciary
ભગાડ્યો	chased away
સાયબર	Cyber cyber
અક્ટૂબરનું	Of October
કગાર	Kagar
સાઉથ	South
રાજધાની	Capital
એક્ટર્સના	of actors
ઇનાયાની	Inayani
130થી	From 130
શક્તિ	force
દેવગણનું	Devgan's
આનંદોઃ	Joys:
લો	Take
પ્રોફાઇલની	Profile
કપલ્સ	Couples
ખીસ્સામાં	In the pocket
મામુલી	Mamuli
સેનનો	Sen's
ફંડા	Funda
અખાત્રીજે	Akhatrije
સ્મિથ	Smith
વ્હોટસએપ	WhatsApp
ક્રાઈમ	Crime
70માં	In 70
યોજાઈ	Held
સ્થળે	in place
માંગ્યો	Asked for
રાખવાનો	To keep
આંસુ	tear
ધર્મેન્દ્રએ	Dharmendra
રણવીરનું	Ranveer's
દિવસની	of the day
બનાવેલો	Created
સમીર	Sameer
સમય	time
બિહારમાં	In Bihar
ચઢયો	Climbed
શાહરુખના	Shah Rukh's
રાજકોટ	Rajkot
મિમિક્રી	Mimicry
ખરીદનારને	to the buyer
ઈન્ટેન્સ	Intense
રિપોર્ટ	Report
કમાલ	Kamaal
હજાર	Thousand
ભ્રષ્ટ્રાચારનું	of corruption
વિરુદ્ધની	opposite
મેકઅપ	Makeup
ટ્રાઇની	TRAI
રીતે	In a way
કરાતા	done
એવરેજ	Average
વાતોનું	of things
ચેતી	Cheti
રુપિયાના	rupees
આપવી	Giving
વિક્કી	Vicky
જેણે	who
કરાયું	Done
પ્રકાશની	of light
વિદ્યાર્થીઓ	Students
તોડવાનો	To break
ઠાકરેના	Thackeray's
નેતાઓના	Leaders
લવર્સ	Lovers
મુંબઈમાં	In Mumbai
કારે	Car
ગોલ્સ	Goals
સતાવી	Persecuted
એક્સ્પો	Expo
વિચારકોની	of thinkers
સાવંતને	To Sawant
ખુદ	Itself
વાઘાણીએ	Vaghani
મીનિટથી	From minute to minute
ઠસ્સો	Thasso
સહિત	Including
ભરપાઈ	Reimbursement
અભિનેત્રીઓ	Actresses
ગુમાવ્યો	Lost
મગમાં	in the mug
ખુબજ	Too much
એકટ્રેસની	Of the actress
સીતા	Sita
દીકરીનું	of the daughter
વિવાદના	of dispute
જેલમાં	in jail
શરૂઆત	beginning
જોશ	Josh
ટ્વિટ	Tweet
સંભાળી	Handled
10750ની	10750
રીતિકે	Ritike
કરતાં	rather than
ગેસ્ટની	Guest's
થવું	happen
પહોચતા	Arriving
માલ્યાએ	Mallya
ઇન્ડસ્ટ્રી	Industry
નવેમ્બરનાં	Of November
નીચેથી	From below
જલોટા	Jalota
હજારોની	of thousands
લોન્ચમાં	In launch
451ની	Of 451
જ્હાનવીને	To Jhanvi
સુબ્રમણ્યન	Subramanian
જાહેરનામું	Notification
મોમ્સ	Moms
શક્યતા	possibility
નામ	name
ગેટ્સે	Gates
ડિસૂઝા	D'Souza
પહેર્યુ	Wearing
છાપાએ	In the press
બોક્સ	Box
ફિલ્મનો	Of the film
કેસઃ	Case:
સુધીના	Up to
ગુમાવ્યા	Lost
હળવાશમાં	in a lighter vein
વીમાના	Insurance
હેન્ડ	Hand
ઈતિહાસ	History
મેમ્બરશિપ	Membership
લિયોનીની	Leoni's
સુપરકાર	Supercar
નથીઃ	No:
રચ્યો	Created
અમીરો	Amiro
પેન્ડલની	of the pandal
બેન્કો	Banks
વિપક્ષે	Opposition
સિંધી	Sindhi
વિશાલની	Vishal's
કલચર	Culture
પત્નીનો	of the wife
આજીજી	Aajiji
એવરેજના	of average
રાખીને	Keeping
10525ની	Of 10525
દીકરીનાં	of the daughter
ગેમ	Game
પટણીનો	Of Patni
જૂનથી	From June
જોયા	Saw
પરચમ	Parcham
યાદવના	Yadav's
પિટારો	Pitaro
સિદ્ધિવિનાયક	Siddhivinayak
હસી	Laughed
અબ	Ab
ખોટઃશનિવાર	Loss: Saturday
અંગૂરી	Angoori
નકલીની	of fake
મહારાજા	Maharaja
કેન્દ્રનું	Of the Centre
મજાની	Fun
કેટલાં	How many
અફેર	Affair
ગુલાબો	Roses
કારની	car
કર્મચારીઓના	employees
બાથટબ	Bathtub
સૂવા	To sleep
લૂકની	Luke's
બેંકિંગ	Banking
છપાવી	Printed
ખિસ્સા	Pocket
બ્રેકઅપનાં	Of a breakup
આખરી	The last
કિલોથી	by kilo
રાખે	Keep
ટ્રિલિયન	trillion
સિનેમા	Cinema
ચોક્કસથી	Certainly
મૂડીમાં	in capital
ગેંગરેપઃ	Gang rape:
જીએસટીથી	from GST
ટ્યૂલિપની	Tulipani
બ્લોકબસ્ટર	Blockbuster
એકાઉન્ટમાં	In the account
રાજ્યભરમાં	across the state
છેલ્લી	Last
ત્યાં	Over there
ખાનનો	Khan's
આણંદઃભંગાર	Anand: Bhangar
નેહાએ	Neha
લેવાના	To take
ભવદીપ	Bhavdeep
કલ્પેશ	Kalpesh
ડોગ્સ	Dogs
છિલ્લર	Chhillar
કિંગ	King
માય	Mai
જાતીય	Sexual
લૉન્ચ	Launch
ભરૂચઃપાણીનો	Bharuch: Water
શિયોમીએ	Xiaomi
વિલને	Will
હોટનેસથી	from hotness
સ્ત્રી	woman
ન્યૂ	New
અલોકનાથ	Aloknath
ગ્રાહકોની	of customers
કેમિકલ્સથી	From Chemicals
માણતી	enjoying
ગર્વનરની	Governor's
રાજકોટઃસિંગતેલમાં	Rajkot: In Singtel
ડાયાબિટીઝથી	from diabetes
રાખવાના	to keep
ડ્રેસિસમાં	In dresses
બતાવું	Show
લઈ	Take
ભાડામાં	On rent
ન્યૂયોર્કનાં	Of New York
બિઝનેસને	To the business
ઓલ	All
ઊભા	Stand up
વેચાતું	Selling
રાજન	Rajan
લોકને	To Locke
રૂપિયોમાં	in rupees
અમેરિકાને	To America
સીરિયલ	Serial
અપડેટ	Update
ગર્લફેન્ડ	Girlfriend
ખેચાવી	Pulling away
પ્રદર્શન	Exhibition
ગણપતિ	Ganpati
સિક્વલ	Sequel
0એ	0A
શટલ	Shuttle
કૂમારની	Kumarani
હુશ્નના	Hushna
પટાવતો	Beating
પ્રાચી	Prachi
રાય	Rai
અપના	Apna
દુકાનો	Shops
રોકેટ	Rocket
કોર્ટનો	Court of
પહોંચ્યાં	arrived
મુકતા	dropping
રદ્દ	Cancel
સ્વાર્થનો	selfish
3દિવસથી	From 3 days
લીધો	Taken
થાય	happens
ચેક	Czech
મામલો	The case
ફિલ્મને	Film
નિયમોથી	By the rules
નિકે	Nick
દુનિયાનો	of the world
વધું	More
માંડ્યા	Mandya
મોતનાં	of death
કચ્છી	Kutchi
નોંધાવ્યું	Registered
તા	Ta
પર્સનલ	Personal
દીકરીની	of the daughter
અપની	Apni
સર્ટિફિકેટ	Certificate
મકાનમાં	in the house
વિવાદોમાં	in disputes
પહેરેલો	Worn
આઇડિયાના	Idea's
કુંવારાઓ	Virgins
બંન્નેની	of both
ડિવિડન્ડના	of dividends
આ	this
વસુલ્યા	Vasulaya
પ્લેનની	of the plane
ટીમ	Team
રનૌતની	Ranaut's
સિને	Cine
પ્લસ	Plus
ટન	Ton
ચુમ્મા	Chumma
દરમિયાન	Meanwhile
કેગનો	THE CAG
ફિક્સ	Fix
મહિલાનો	the woman's
નણંદે	Nanande
વેઇટિંગ	Waiting
બોલાયો	Spoken
સંપૂર્ણં	Complete
વોયસ	Voyes
સ્તરે	At the level
રક્ષાબંધન	Raksha Bandhan
મહેફિલ	Mehfil
ખૂશ	Khush
ચાંદી	silver
અનુપમ	Anupam
નથીને	Not
શરૂમાં	In the beginning
કટ્સ	Cuts
ધવને	Dhawan
સત્રના	of the session
ત્રિશલા	Trishala
ઓવારી	Ovari
ઊર્મિશીલ	Urmishil
આવશે	will come
ઈન્વેસ્ટ	Invest
ઓરિજનલ	Original
શુક્રવારના	Friday's
રણબિરને	To Ranbir
રઘુ	Raghu
ફીમાં	in fees
પીધી	Drinking
મંદિરમાં	in the temple
સચિન	Sachin
બ્રેગ્ઝિટ	Braggit
વર્ષમાં	In a year
રિટેલ	Retail
શાંધાઈમાં	In Shanghai
રણવીર	Ranveer
વહેંચો	Share
ચોપડાના	Chopra's
સંબંધ	Relationship
ખેર	Kheer
લખીને	By writing
ઝકરબર્ગની	Zuckerberg's
પત્નીએ	wife
આસુસ	Asus
નોકરી	Job
બધું	Everything
સુશાંત	Sushant
ઇન્ડિયાનું	Of India
સ્પર્ધકોની	of the contestants
બોલ્‍ડ	Bold
પ્રાઈમ	Prime
બ્રાન્ચ	Branch
લઘુત્તમ	Minimum
મળવાની	To meet
ડબ્બાનો	of the box
ઉપાડના	Of withdrawals
કુમારી	Kumari
મહેમાનોને	To the guests
કાળો	Black
પોલીસીઃ	Policy:
સેનસેક્સ	Sensex
અમેરિકાના	America's
વૈશ્વિક	Global
પુસ્તકો	Books
જોવડાવ્યા	Watched
ખુલ્લેઆમ	Openly
એક્સક્લૂસિવ	Exclusive
વાઇડ	Wide
100માં	In 100
ગઇ	Gone
એકમાત્ર	The only
ડાઉન	Down
ધોઇ	Washed
અવોર્ડસ	Awards
રાજકોટઃઅમદાવાદને	Rajkot: Ahmedabad
દિવો	Divas
દેખાયો	appeared
દેશોના	Countries
ડાયલોગ	Dialog
ફોટાવાળું	photoable
મોટાભાઇ	Elder brother
ગામડાઓ	Villages
યુઝર્સના	of the users
સારાનો	Of Sara
પરંપરાગત	Traditional
દો	Let it be
ધકેલનાર	Pusher
બાળપણ	Childhood
નાબુદ	Nabud
યાદમાં	In remembrance
પ્રશંસકો	Fans
પપ્પૂ	Pappu
કોઇએ	Someone
પેન્શનની	of pension
બંનેએ	Both of them
રીત	Way
સીરિઝનો	of the series
ગરમીમાં	in the heat
2500માં	In 2500
બદલાતો	Changing
બ્રેન	Brain
મેગેઝિનનાં	Magazine's
સેન્સરને	to the sensor
ચુકવવાના	To pay
નોમિનેશનમાં	In nominations
ગિફ્ટ	Gift
પ્રેસ	Press
ગણું	Count
પ્લાનિંગ	Planning
ફોર્ચ્યૂનર	Fortuner
નોકરીની	Job
ગ્રાહક	consumer
એટેકની	of the attack
પરેશ	Paresh
આપીને	by giving
આટલામાં	In the meantime
જેવું	Like
બાત	Baat
કયો	Which
શહિદ	Shahid
પદની	Of the post
તરફથી	from
દેશએ	country
કુકએ	Cook
સળંગ	Continuous
મંચ	Stage
કરન્સી	Currency
ભારતનો	Of India
કરો	Do
વિતાવવો	To spend
આલિયાથી	From Alia
એકાઉન્ટનો	account
મસ્તીના	Mastina
સંસ્કારીથી	from sanskari
ભ્રષ્ટાચારનો	of corruption
પકડાયેલી	Caught
નિરાશ	disappointed
ફેબ્રુઆરીનાં	Of February
ફાઉન્ડરે	Founder
સનલાઇટ	Sunlight
ફાડ	Phad
બજેટમાં	Budget
કોઇને	Someone
વિક	Vic
ઘટે	decreasing
મચાવતી	Creating
સંસદીય	Parliamentary
મૌલવીની	Maulvi's
વ્યકિતનો	of the person
મા	mother
મુકેશ	Mukesh
ટાંચમાં	In stitches
સમજતા	understand
નારા	Nara
ગર્લ	Girl
હોબાળો	Uproar
લખ્યો	Written
વેચાઇ	Sold
ટિમ	Tim
ભારતીયો	Indians
બોજ	Burden
ગ્રેજ્યુટી	Gratuity
ગ્રાહકોના	of customers
બેલાના	Belana
કમાણીના	Earnings
રાષ્ટ્રીયકૃત	Nationalised
સેકન્ડ	second
ઝઝુમી	Jazumi
સ્વાસ્થ	Healthy
પહેલાં	Before
5નો	of 5
સોહામણા	Sohamana
પાવરહાઉસ	Powerhouse
ચીનમાં	In China
સન્સ	Sons
રિપોર્ટમાં	In the report
ફોટોઝ	Photos
ભટ્ટની	Bhatt's
કોઇનો	someone's
માલિકે	The owner
ફટાકથી	From the cracker
ઝોનથી	From zone
ચોકસીએ	Choksi
ખોટી	Wrong
બિઝનેસ	Business
સંગીતમાં	In Music
કુંભમાં	In Kumbh
ત્રીજુ	The third
પ્રદેશનાં	of the region
મોદીનું	Modi's
બાય	Bye
બ્રિટન	Britain
7990માં	In 7990
ભોપાલથી	From Bhopal
રનર	Runner
બનવામાં	in becoming
નિવેદનઃ	Statement:
રણવીરની	Ranveer's
મચાવવા	To create
હેક	Hack
બિલિયનર્સ	Billionaires
બાજીરાવ	Bajirao
બેન્કિગ	Banking
પુત્રના	of the son
જુલાઈથી	From July
જાણકારી	information
રિસીવ	Received
ડયુટી	Duty
મલ્લિકા	Mallika
ઉછળવા	bouncing
રાજ્યમં	in the state
કરીનાએ	Kareena
2400નું	Of 2400
દીકરીઓને	To the daughters
કાફલો	Convoy
2100થી	From 2100
ચઢી	Climb up
ખીસ્સા	Khissa
સ્ટેશન	station
ઓફિસમાં	in the office
ભીતિ	Fear
ડિસપ્લે	Display
યાદી	List
પીડિતાને	to the victim
3500નું	Of 3500
ક્રમાંક	Number
હિરોઇનોને	Heroines
મોકળો	Open
સ્કિલ	Skill
ઉચાપતની	of high-handedness
ગુમાવ્યું	Lost
વ્હેલ	Whale
નિકાસમાં	In exports
જાહેર	Public
જરૂરતની	of need
સેન્ચુરી	Century
આવેલા	Arrived
આઇડી	ID
બજેટના	Of the Budget
કમાણીમાં	In earnings
હલ્ક	Hulk
બંધ	closed
સન્માનિત	Honored
કારપેટ	Carpet
ઓઈલ	Oil
અસ્તિત્વમાં	existing
પાર્લર	Parlor
પેનલ	Panel
કોમ્પ્યૂટર	Computer
એકબીજામાં	in each other
કરવાના	to do
દિલકશ	Heartbreaking
રોહિંગ્યા	Rohingya
સિરીઝમાં	In the series
એલપીજી	LPG
પહોચી	arrived
વ્યક્તિત્વ	Personality
ફોલ્ડર	Folder
ડાન્સનો	of dance
બેનર્જીનું	Banerjee's
સમ્રાજ્ઞીની	Empress's
ન્યૂયોર્ક	New York
લાઇમ	Lime
ખાધ	Deficit
સેન્ટ્રો	Santro
વિનોદ	Vinod
નિયમમાં	In the rule
ભાગ	part
કપૂરે	Kapoor
ધ્યાન	care
જુંડ	Jund
લિમિટેડ	Limited
કરોડોનાં	crores of rupees
હોય	is
ખાનનું	Khan's
લેજો	Take
વિખેર્યા	Scattered
શકાયઃ	Can:
કમાંડર	Commander
દોસ્તી	Friendship
મધરાતથી	From midnight
પ્રકરણની	Chapter
પતલી	Thin
બુરખાની	Burkhani
13મા	13th
પાછો	Back
ઉતારીને	By unloading
મહિન્દ્રાએ	Mahindra
હાશકારો	Laughers
હટકે	Hatke
મહબુબા	Mehbooba
નોકરીમાંથી	From the job
આરોપી	accused
રદબાતલ	Cancellation
સેમી	Semi
ઉંમરે	Age
પુરૂષો	Men
સિંઘમ	Singham
પાકિસ્તાનને	to Pakistan
ત્યાગી	Tyagi
નંબરનો	number
બચ્ચનનાં	Bachchan's
સાજીદે	Sajide
રિઆલીટી	Reality
મેગીને	Maggie
તો	So
નજરઃશું	Look at what
એટલી	So much
કરપ્શન	Corruption
છપાયેલી	Printed
તરફ	Towards
લોટને	to the flour
ભરવી	Filling in
દુઃખાવો	Pain
ચીડાઇને	irritated
ખુલતા	Opening
ટેકનોલોજી	Technology
આવ્યું	Came
જાન્યુ	January
કામો	Works
ગેટ્સ	Gates
પોતાની	own
નામાંકિત	distinguished
નાણાંને	to money
ફાટેલી	Cracked
કેસની	case of
ઇંચનું	of inches
રિવરફ્રન્ટની	of the riverfront
ગેર	Ger
પરિષદ	Conference
મારામારી	beating
પ્રસ્તાવ	Proposal
ડૉ	Dr.
150થી	From 150
સજ્જડ	tight
છુપાવવાને	To hide
મૂકાયું	Placed
મેં	I
ભાગ્યા	Ran away
મેહતા	Mehta
સબમરિન	Submarine
ચુક્યો	Missed
25થી30	25 to 30
નીતિઓના	of policies
રેપનો	Rapno
મૂડમાં	in the mood
નોટોની	notes
બેન્કિંગ	Banking
વાઘા	Wagah
સિલેન્ડરના	Of the cylinder
68માં	In 68
અભિજીત	Abhijeet
બિબરની	Bieber's
ફિવર	Fever
સ્માર્ટફોનથી	From smartphone
આવનારા	Coming
રુપિયા	Rupees
શરતો	Terms
તમને	You
ફૂલ	flower
શુઝ	Shoes
ટીઝરમાં	In the teaser
બધુ	Everything
નાજૂક	fragile
બાપ્પાના	Bappana
7000ની	7000
એલીએ	Eli
પોલીસે	Police
ફાટવા	To crack
બંનેનાં	of both
સ્વરાના	Swarana
પુરુષે	the man
ક્રેઝ	Craze
લે	Take
નમસ્તે	Hello
ફોટાએ	Photos
ડિજિટલ	Digital
ફ્લીપકાર્ટ	Flipkart
નોટો	Notes
દેવ	God
રિવાજથી	By custom
આઇટી	IT
ઝૈન	Zain
મૌલી	Mauli
સ્પોર્ટ	Sport
મંત્રીએ	Minister
યૂઝર્સનો	of the users
ચલણ	currency
ગાઇશ	Gaish
પૂર્ણ	Complete
મીઠા	Sweet
સ્પીડના	Speed of
અરુણ	Arun
એપ્રિલે	In April
બિઝનેસમાં	In business
જેટલા	As much as
રેસ્ટોરન્ટના	of the restaurant
જર્મનીના	Of Germany
લેવાતી	Taking
મોહબત્તે	Mohabbatein
કમનસીબ	Unfortunate
વક્તા	Speaker
બોલાવવા	To call
દિકરીને	to the daughter
મેગાપિક્સેલ	megapixel
ચોથી	Fourth
યુનિ	Uni
પેટ્રોલના	of petrol
આપની	Yours
ઈવેન્ટમાં	At the event
હિરોઇનો	Heroines
તમેજ	You're the one
કોમેડિયને	Comedian
બ્રાંચે	Branch
વિતાવ્યા	Spent
સપનું	Dreams
જોવાનું	To see
ધુપિયાએ	Dhupia
પદથી	From the post
ચેતવણી	Warning
દેહ	body
પૉઇન્ટનું	of point
સ્કેનથી	from the scan
બનાવેલી	Created
ઇરફાને	To Irfan
મેકર	Maker
દુનિયાના	the world
તૈમૂરનો	Taimur's
નાખે	cast
એન્ડ્રોઇડ	Android
વ્હાઇટ	White
ખર્ચ	Expenses
દરોડા	Raids
રૂપિયાનું	Rupees
લાખનાં	of millions
આજનાં	Today's
પૂર્વસૂરિઓને	To the forefathers
વિનિત	Vineet
એ	it
સીડીથી	from the stairs
હોંડાનું	Of Honda
200નું	Of 200
સ્પાયનાં	Spyna
નશામાં	Drunk
પોપટલાલનાં	Of Popatlal
બડજાત્યાનું	Badjatya's
ગેરંટી	Guaranteed
મકાન	building
એન્જોય	Anjoy
રાખ્યો	Kept
બોલનાર	Speaker
ગુજરાતથી	From Gujarat
નાણામંત્રીએ	The Finance Minister
ફ્રૉડ	Freud
જિજ્ઞેશ	Jignesh
મલાઈકાએ	Malaika
રિફાઇનરીમાં	In the refinery
ઠંડા	Cold
ગરમ	hot
દબદબો	Doodh
પહેરાવવા	To wear
ઘટાડ્યા	Reduced
બિન્દાસ	Bindass
એપલના	Apple's
પડોશી	Neighbor
સપ્ટેમ્બરના	September
કન્યાદાન	Kanyadaan
રાજ્યપાલે	The Governor
ચશ્મા	Glasses
લડત	Fighting
ચોરાયા	Choraya
માણવા	To enjoy
હો	Ho
ખોલ્યુ	Opened
ઇંધણ	Fuel
કારોની	Cars
બનાવાઈ	Created
સ્વીકારાય	Accepted
વિધિ	Ritual
પોષણક્ષમ	Nutritious
બનાવવાની	To Create
અફલાતુન	Aflatoon
કેરળ	Kerala
પ્રમોટ	Promoted
સુધરશે	will improve
લાંબા	Long
આંટીનું	of the aunt
૨૦૦૦ની	of 2000
બમણી	Double
લેતી	Taking
પુરૂ	Puru
તોડ્યું	Broken
સાઉથનાં	of the South
જીયોની	Gionee
વધતા	Growing up
સ્પેસ	Space
કંપનીઓની	companies
ડ્યૂટીનો	of duty
વિશ્વરૂપ	World form
સોના	Gold
નોટના	Notana
વીમાનો	Insurance
પ્રવાહથી	by stream
ટૂર	Tour
પતિને	husband
11મા	11th
ભાંગી	Broken
સેનામાં	in the army
કહેવું	say
ફેરવી	Rotate
લોન	Loan
મેસજ	Mess
ઉઠ્યું	Got up
ડાન્સર	Dancer
ડિવાઇસના	of the device
નેવીના	Navy's
નહિઃ	No:
મોહબ્બત	Mohabbat
યૂઝર્સે	Users
અંધારામાં	In the dark
દાંડેકરે	Dandekare
કિસથી	From Kiss
નોટિફિકેશનથી	By notification
અડગ	Adag
વઘવાના	Waghwana
નીતિઓથી	by policies
મુશ્કેલીમાં	In trouble
રિયર	Rear
બેફામ	Bepham
દિ	the
નગરી	City
ઋષિ	Sage
જેવા	like
રાત્રી	night
2000ને	To 2000
રમ્યા	Played
લગાવીને	by putting
વરણી	Varni
બહુ	many
ઓશીકું	Pillow
જેનરની	Jenner's
પૂલમાં	in the pool
ભણાવવાની	To teach
81નાં	Of 81
અબ્રાહમની	Abraham's
લગાવો	Apply
પેઇડ	Paid
ફાયદાઓ	Benefits
કરોડના	crores of
પહોંચેલી	Arrived
સંસદમાં	In Parliament
યાર્ડમાં	In the yard
ફ્લાઇટો	Flights
ખંડેલવાલ	Khandelwal
સ્વિમ	Swim
વકીલો	Lawyers
એવેન્જર	Avenger
કંગનાનું	Kangana's
પતાવી	Finished
રણબીરનાં	Ranbir's
આવ્યો	came
મુદત	Term
ખુશખબરી	Good news
લખવા	To write
લાખનો	of millions
ફ્રામ્સ	Frams
પ્રશ્નના	Question
આરોપ	Allegations
યો	Yo
માનુષી	Manushi
મેસેજને	to the message
રવિવારે	On Sunday
વિતાવશે	will spend
સુધારી	Updated
અવમૂલ્યન	Devaluation
આરોપોમાં	in the charges
જરૂરી	needful
મળેલી	Received
ઝૈનના	Zaynna
વેપારમાં	In business
થોડુ	A little
મલ્હોત્રાએ	Malhotra
લાગ્યુ	Felt like
એક્વા	Aqua
હોવાના	to be
મહાદેવ	Mahadeva
કામની	Work
કર્યુંઃમંત્રી	Did: Minister
લાયસન્સ	License
કેન્દ્રઃ	Centre:
બનવા	to be
વીજય	Vijay
અંબાણીનું	Ambani's
લાગ્યું	Felt
પ્લેટફોર્મ	Platform
આપવીતી	Giving
સની	Sunny
આજના	Today's
પડેલો	Lying down
હિન્દુ	Hindu
દીકરીએ	daughter
ટોની	Tony
હાહાકાર	Shouting
દીવો	lamp
ઠાકરે	Thackeray
એવુ	Such is the case
જીત્યુ	Won
સસ્તામાં	Cheaply
ખુદાથી	From God
જીવનમાં	In life
તેમાં	In it
કુનાલ	Kunal
વિદ્યાર્થીઓએ	Students
એક્સાઇઝ	Excise
સૌરાષ્ટ્ર	Saurashtra
પુરાવો	Evidence
સીસું	Lead
બહેન	Sister
નાના	Small
ગેઝેટ્સ	Gadgets
પડનાર	Faller
જુગારમાં	In gambling
મૌલા	Maula
ગદગદ	Gadgad
બંપને	To the bump
ચૌહાણે	Chauhan
સજ્જ	ready
શ્રીદેવીને	To Sridevi
પ્રોપર્ટી	Property
ટેલિકોમ	Telecom
સ્વીકારાતાં	Accepting
ઉંમરમાં	In age
કમબેક	Comeback
મેન્યૂ	Menu
વેપારીઓના	of traders
આઇફોન	iPhone
ચિદંબરમને	Chidambaram
નાણામંત્રાલય	Ministry of Finance
ધુપિયા	Dhupia
મૂડ	Mood
મદમસ્ત	Madmasta
મોકલી	Sent
દેના	Dena
આપવો	Giving
ગ્રોથને	Growth
ફિલ્મફેર	Filmfare
સ્માર્ટનો	Smart's
લાગે	Looks like
તેનાથી	From that
થયેલા	done
થતું	Happening
જમીનની	land
પટેલનો	Patel's
હસબન્ડને	To Hasband
પર્સ	purse
પકડીને	Holding on
દર્શાવી	Displayed
આસું	Aasu
સોન્ગનાં	Song's
યોગાની	Yoga
ખોરો	Khor
કરચલાને	To crabs
આરોહી	Aarohi
રીતથી	in a way
જાહ્નવીનું	Jahnavi's
ધકેલાયું	Pushed
રાજકોટઃચેમ્બર્સ	Rajkot: Chambers
બિસ્તરા	Bistara
ય	y
લૂમિયા	Lumia
પાસે	have
શાહનો	Shah's
બુકીંગ	Bookings
બિપ્લવ	Biplab
વિનેશને	To Vinesh
ચમકી	Shining
વહુ	Bahu
કુવૈતમાં	in Kuwait
ચોરીછૂપીથી	stealthily
સરકારના	Government
અબજો	Billions
જવાબદાર	Responsible
ચૌધરીએ	Chaudhary
મેહરાની	Mehrani
અમૃતસરમાં	in Amritsar
મેસેજિંગ	Messaging
બુક	Book
પ્લાનથી	From the plan
વેલેન્ટાઇન	Valentine's
દિવસમાં	During the day
પુરો	Complete
5થી	From 5
કરાવો	Get It Done
ચક્રવર્તીએ	Chakravarty
પત્તુ	Leaf
રેખા	Line
લાઇફ	Life
ઈરફાનની	Irfan's
જાઓ	Go
બહેનથી	From sister
કોંકણી	Konkani
ખેલ	Game
ડાન્સની	of dance
અર્પિતાને	To Arpita
એક્ટ્રેસ	Actress
ફસાંઇ	Trapped
26મી	26th
જીતની	of victory
મોચીને	Mochi
પાજી	Paaji
એવિએશન	Aviation
બિલ્ડર્સ	Builders
300પોઇન્ટનો	Of 300 points
કોશ્ચ્યુમમાં	In the costume
મોંઘુ	Expensive
શાદી	Shaadi
ટ્રમ્પના	Trump's
બિટકોઈનનો	of bitcoin
સેફ્ટી	Safety
પાડોસીઓએ	Neighbours
બજેટને	To the Budget
14થી	From 14
નાથનુ	Nathnu
ઝોયા	Zoya
મમતા	Mamta
અઢળક	Too much
પછાડવા	To beat
પ્રિટી	Pretty
મારઃ	Mar:
ડિબેટમાં	In debate
કંપનીની	Company's
લાગૂ	Applicable
નાગિને	Nagine
દેશોને	to countries
મિકેનિકથી	From mechanic
જેગુઆર	Jaguar
જાણી	Know
સરક્યા	slipped
સમાધાનઃબાબા	Solution: Baba
એક્સાઇટમેન્ટનો	of excitement
ખુબસરસ	Very nice
ક્રેટાને	To Creta
થોડીક	A little
કેનેડામાં	In Canada
ટેકાના	Support
અકબંધ	Intact
એશિયાની	of Asia
પાંગરેલો	Pangrelo
વચગાળાના	Interim
જુઓ	Look out
ઇલેકટ્રીક	Electric
મોનલ	Monal
શહેરમાં	in the city
દયા	Mercy
ખરીદવો	Buy
કેલેન્ડર	Calendar
એલીનો	Ellino
બેંકે	Bank
અવકાશયાત્રી	Astronauts
ખેતરોમાં	in the fields
ચાલ્યો	Gone
દેખાઈ	appeared
નેગેટિવ	Negative
નિહારિકા	nebula
આપત્તિ	Disaster
20ફાર્મા	20Pharma
સુઝૈનનાં	Suzanne's
ફાફડા	Fafda
કરેલી	Done
ભળી	Merged
રજાના	Holidays
અપાય	Given
જમીન	earth
અલવીદા	Alvida
વખાણ	Praise
મિત્ર	friend
કાંતતા	spinning
અંગત	Personal
શ્રીદેવીનું	Of Sridevi
લોકોએ	People
પેક	Pack
મીટરમાં	in meters
યુવાનોમાં	among the youth
યથાવત	As it is
વેચી	Sold
ત્રીજી	The third
આયાત	Imported
ડબ્બૂ	Dabboo
ફેબ્રુઆરીમાં	In February
છૂટી	Released
સિદ્ધાર્થની	Siddhartha's
ખેડૂત	farmer
એક્સપાયરી	Expiry
મમ્મીએ	Mom
કિંગ્સની	Of the Kings
રિજેક્ટ	Rejected
યુનિવર્સિટી	university
પોઇન્ટના	of the point
ઉતારવા	Unloading
ડેની	Danny
સોજી	Soji
વિશ્વભરમાં	Around the world
વાયુસેનાએ	Air Force
ધાબીમાં	In Dhabi
મનપા	Manpa
ચમકશે	will shine
ચૂલ્હો	Chulho
જામીનપાત્ર	bailable
શફી	Shafi
નવાઇ	Surprised
વાપરતા	Used
પ્રિંસ	Prince
સરાહના	Sarahna
બિયર	Beer
નવમા	ninth
ટ્રીટ	Treat
આહુજાના	Ahuja's
ફેબ્રુઆરીથી	From February
જોડાયું	Connected
ભવિષ્યની	Future
જોડાયા	Joined
હતા	were
પોટલી	Potley
બસુએ	Basu
ટેલીકોમ	Telecom
ફેંકી	Thrown away
કૌશલ	Kaushal
વૃદ્ધિદર	growth rate
શરતે	On condition
મંડપ	Mandapa
જ્યા	sine
ધના	Dhana
દીધું	given
ગેંદા	Genda
ખરીદ્યું	Bought
ભૂમિકા	Role
લવરાત્રિ	Loveratri
ઘી	ghee
સ્વાભિમાની	self-respect
શક્યતાઃ	Chances:
લાખ	lakh
રૂપાલીમાં	In Rupali
સાંભળ્યુ	Heard
અપકમિંગ	Upcoming
દાઉદ	Dawood
પ્રતાપનો	Pratap's
બોસની	Boss's
માલકણ	Malkan
હિંમતનગર	Himmatnagar
નહાય	Bathing
સેવાઓનો	of the Services
સંપૂર્ણ	Complete
દયાભાભીની	Dayabhabhi's
અંજના	Anjana
અબ્રાહમે	Abraham
251ની	Of 251
ડૂબ્યા	drowned
શૂટમાં	In the shoot
રૂ	cotton
માનવામાં	Believed
ભરવા	To fill
અનિચ્છીય	Undesirable
સ્ટેશનમાં	at the station
કનેક્શન	Connection
500માં	In 500
એપથી	from the app
બેન્ઝને	Benz
વેચાઈ	Sold out
વિકી	Vicky
વારસીનું	Warsi's
પ્રેમી	lover
ગર્વ	Proud
પપ્પાના	Dad's
થોમસન	Thomson
મળશે	Will get
પ્રત્યર્પણની	Of extradition
કરે	does
લટ્ટુ	Lattu
પાટણઃકોગ્રેસ	Patan: Congress
બંગલો	Bungalows
સ્ટોરી	Story
પિચાઇ	Pichai
ઇતિહાસ	history
નાખવા	To cast
વિકાસકાર્યોને	Development works
જૂને	June
જિનિયસની	of a genius
પંચમદાને	Panchamdane
ઈન	In
પ્રભાસ	Prabhas
દેવસેના	Devasena
ઓગસ્ટ	August
તૈમૂરને	To Taimur
રુવાટા	Ruwata
સુધીની	up to
રીટેલની	Of Retail
રિશ્તા	Rishta
હરણના	of deer
બબ્લુ	Bablu
કેશની	Cassini
લોન્ય	Lonya
સામીનાં	Samina
ટેક્ષમાં	In tax
કેટરીનાના	Katrina's
સીન	Scene
શેરિંગ	Sharing
ચાર	Four
બિન	Non
સ્કાય	Skye
અમેજોનનું	Amazon's
અખબાર	Newspaper
વસૂલવા	to recover
કરી	kari
લડશે	will fight
વે	Way
એંગ્રી	Angry
આર્ટિફિશિયલ	Artificial
સૌંદર્યાનું	Soundarya's
બનાના	Banana
સિક્યોર	Secure
વિશ્વના	The world
કાઢુ	Remove
બાહુબલીમાં	In Baahubali
12ની	of 12
લાવશે	Will bring
ચોકસી	Choksi
જાટ	Jat
સેક્સુઆલિટી	Sexuality
યલો	Yellow
તેજ	Bright
ફંકશનમાં	In the function
ટેવથી	By habit
સેક્ટરને	To sector
રાહ	Wait
તબિયતમાં	in health
સહેલુ	Easy
કાર્તિકની	Karthik's
પ્રત્યર્પણ	Extradition
બોક્સર	Boxer
અદનાન	Adnan
કહ્યો	said
મોબાઈલમાં	In mobile
મોની	Moni
બનાવ્યો	created
ઊંઝા	Unja
મુસાફરો	Passengers
ઉપલબ્ધ	Available
જ્હોનના	John's
જેટલીના	Jaitley's
એડલ્ટ	Adult
એન્ફિલ્ડને	To Anfield
ખિસ્સામાં	In the pocket
ગુપ્તાએ	Gupta
જિલ્લા	District
25મીએ	On the 25th
ટિકિટના	of the ticket
વરૂણ	Varun
મોટો	Big
ભરવામાં	In filling
પહેરી	Wearing
કચેરીના	Of the office
અવાજમાં	In voice
બાબતો	Things
જીવનની	Life
પિરિયડ	Period
મીડિયાએ	The media
શોધતા	Searching
રોકાયા	Stayed
બબ્બરે	Babbare
ટોકનથી	By Token
બાબતે	About the matter
પહેલા	First
મેદાનમાં	in the field
સ્ટૂડન્ટ	Student
એરિકાનો	Ericano
દુબઇ	Dubai
નિફટીમાં	In Nifty
બતાવાયો	Shown
સ્ટેચ્યૂ	Statue
લાગેલા	felt
સંગીતથી	From music
કરાવવામાં	to get it done
શંકરે	Shankar
નિમણૂક	Appointment
નિતિન	Nitin
અવતાર’ને	Avatar'
માને	Mane
પૂરી	Complete
ટી	T
અર્થશાસ્ત્રીએ	The economist
સુકન્યા	Sukanya
એપલે	Apple
જિયોની	Jio's
પણ	also
ખેંચીને	By dragging
ભૂમિ	earth
ડાયમંડની	of diamond
સૌ	All
વ્હીકલનો	of the vehicle
ફિલ્મ્સ	Films
3કરોડનું	3 crore
છેવટે	After all
ધક્કામુક્કી	Dhakkamukki
બંનેનો	of both
આવવાથી	By coming
નન	Nun
બાબતોનું	of affairs
ગિન્નીનાં	Ginni's
સ્માર્ટવોચ	Smartwatch
ભ્રષ્ટ	Corrupt
ગેસ	Gas
અભિજીતનો	Abhijeet's
ફરજીયાત	Mandatory
રો	Ro
પૂરો	Complete
હાઇ	High
સુજ્યું	Swollen
બેચલર	Bachelor
મેપ્સના	Of maps
નડ્યો	shaky
ઘટાડ્યાં	Reduced
વીડિયોકોન	Videocon
આંતરીક	Internal
મિટર	meter
આરામની	of rest
સેફ	Safe
મેગેઝીન	Magazine
ઝંડી	Flag
કહેશે	will say
દુનિયાભરના	Around the world
કરાવે	Get it done
ઇંચની	of inches
હેડસ્ટેન્ડ	Headstand
પ્રિયંકાનો	Priyanka's
સ્થાને	in place
તૈયાર	ready
જિયોફોન	JioPhone
હાઈવે	Highway
અમેરિકાએ	U.S.
તૈમુરની	Taimur's
જમાનાનો	of the era
ઈકોનોમિસ્ટ	Economist
સમુદ્રી	Marine
ફૂંકે	blowing
ઘરની	At home
બેરોજગારી	Unemployment
યર	Year
જીંદગી	Life
અભણ	Uneducated
ઓફલાઈન	Offline
માનવા	To believe
સ્પેશલ	Special
હયાતે	Hayate
બાવો	Bawo
દેશનાં	of the country
999નો	Of 999
અબજનો	of billions
છોડી	Leave
ચીજો	Things
પુછ્યુ	Asked
કોર્નર	Corner
કૂતરાને	To the dog
અલ્હાબાદ	Allahabad
રાહત	Relief
એરટેલ	Airtel
ક્યારેય	Ever
સિંહનું	of the lion
યૂનિટીની	Of Unity
ડ્રેસ	Dress
અબ્રાહમ	Abraham
બેન	sister
પ્લાનમાં	In the plan
દીપિકાનું	Of Deepika
ગૃહિણીઓનું	Housewives
બેંકોની	of the banks
ક્રેક	Crack
આનંદના	Of joy
મિસ્ત્રીનો	Mistry's
છૂટ	Exemption
વિવિધ	diverse
થશેઃઅરૂણ	Will be: Arun
ગેસ્ટ	Guest
જે	which
એક્સપ્રેસના	Of the Express
કમાલનું	Kamal's
લિયોનીનો	Leoni's
વિગત	Details
રાવણના	Ravana's
ન્યૂડ	Nude
ગાંધીનગરની	Of Gandhinagar
રૂસ્તમ	Rustom
અભ્યાસ	Study
અર્થતંત્રનો	of the economy
તથા	and
જબરા	Jabra
હકિકત	Reality
ઘટાડી	Reduced
એપલ	Apple
વજનમાં	in weight
બિટકોઇન	Bitcoin
ખરીદેલો	Purchased
જોરઃજોઓ	Jor: Jojo
સત્ય	The truth
ઇન્કમ	Income
ભર્યો	Filled
જણાવ્યું	Told
ભારતને	To India
નખની	nails
હડતાળના	of strike
જૈન	Jain
મસ્તી	Fun
ભરેલો	Filled
સિક્કો	coin
તૂરંત	Immediately
હિન્દી	Hindi
કપલે	The couple
બધાઈ	All of them
રિયાલિટી	Reality
કારણો	Reasons
ડેબ્યુ	Debut
મનપામાં	In the CORPORATION
આવેદન	Application
એશ	Ash
યૂનિવર્સલ	Universal
જવેલર્સોએ	Jewelers
વડોદરાના	Vadodara
ભારતમાંથી	from India
11માં	In 11
1થી	From 1
જલવા	Jalwa
મુકેશે	Mukesh
પ્રદેશ18	Region18
ચૂકવવા	to pay
બાપ	Father
લેણદેણ	Transactions
રાત્રે	At night
વિભાગમાં	In section
રોલ	Roll
બ્રાન્ડના	of the brand
વણસેલા	Unsolved
ચૈત્ર	Chaitra
નહોતું	Not
નજરમાં	In the eye
આઝાદીના	of freedom
રોબોટ	Robot
સોદાના	of the deal
ડુબવાનો	To sink
બાબુ	Babu
પાંડેનાં	Pandey's
લાગશેે	It will seem
દેવાળિયા	Bankrupt
વાપસીની	Returning
રેલયાત્રા	Train journey
હાઉસનો	Of the House
પગારમાં	in salary
રહેતો	living
ખેંચાઇ	Dragged
મરજીથી	At will
સાઉદી	Saudi
બ્રાઉઝિંગ	Browsing
કડક	strict
પાડશો	Do it
ધરાવતો	possessed
વીડિયોથી	from the video
ઘુટણે	Kneeling
એમી	Amy
6નો	of 6
રબ	Rab
વધ્યો	increased
અમૃતાની	Amrita's
જન્મદિવસ	Birthday
પાંડેના	Pandey's
માંગે	Wanted to
સેક્રેડ	Sacred
સાબરકાંઠા	Sabarkantha
વ્યાસની	of diameter
માન્યતાએ	Belief
રેશનિંગ	Rationing
દેખાઇ	appeared
ઓપરેટર્સની	operators
કરાવી	done
ઉત્તરાખંડમાં	In Uttarakhand
પાકિસ્તાન	Pakistan
ઉર્મિલા	Urmila
દીકરાનો	of the son
હીરોના	Hero's
ખેડૂતોના	farmers
કેટરીનાની	Katrina's
નાર્કો	Narco
ચૂંટણીમાં	Elections
બહલ	Bahl
નકામા	useless
મહેમાનો	Guests
ટેન્શન	Tension
કાળાં	Black
સુલતાન	sultan
બેહદ	Beyhadh
પાથલ	Pathal
કમેન્ટ’	Comments'
કાલીન	Kalin
મોડલને	to the model
બિયોન્સને	Beyoncé
વોલમાર્ટની	Walmart's
ઈગ્નોર	Ignor
કવિ	poet
ચાદર	sheet
બાબાના	Baba's
પશુપાલન	Animal Husbandry
ભાડુ	Rent
ઘરેણાં	Jewelry
કોશિશ	Try
વેલનેસે	Wellnesse
કેળનાં	Banana
મળવાનું	To meet
મૂડી	capital
એન્ડ્રોઇન	Androin
ગજરાજ	Gajraj
કિસાન	Kisan
લોહી	blood
જવેલર્સ	Jewelers
વોટ્સઅપના	Of WhatsApp
જૂથનું	Of the group
વિકાસની	Development
તેવું	Like that
પશુપાલકોને	To the herders
રાધિકાનું	Radhika's
રમઝાનમાં	In Ramadan
એકનું	of one
ફર્સ્ટ	First
વસૂલ	Recovery
ઇન્ડિયાને	To India
નોચ	Notch
સિદ્ધુને	To Sidhu
ખરીદવાનું	Buying
તમામને	To everyone
મોંઘવારીમાં	in inflation
જાણીએ	Let's know
અજનબી	Ajnabee
માર્ગ	path
વૈજ્ઞાનિક	scientific
મબલક	Mablak
બાઉન્સ	Bounce
બોડીની	of the body
ફાયદો	advantage
જીતેન્દ્રએ	Jeetendra
મહિલાની	of the woman
ગીત	Song
સેનેટરી	Sanitary
ચીનથી	from China
પાકિસ્તાનમાં	In Pakistan
જુનો	Old
ઉપસ્થિત	Present
લોક	Folk
સંપત્તિઃ	Property:
શાઓમીના	Xiaomina
બિકિનીવાળા	Bikini-clad
સૂદ	Sood
અઝિઝ	Aziz
તમારી	Yours
મોલમાં	In the mall
ગ્રામદીઠ	per gram
ક્ષેત્રમાં	in the field
લાગશે	will feel
વૃદ્ધ	Old man
શિક્ષણ	Education
છપાઈ	Printed
જન્મેલા	Born
બાબાનું	Baba's
દીવાના	Diwana
હસીનાએ	Hasina
દરની	Rate
પાછળનું	Back
દોબારા	Dobara
દુનિયામાં	In the world
અભિષેકનો	Abhishek's
ટૈટૂ	Tattoo
સોનાલીના	Sonali's
જીવનને	Life
બાબા	Baba
નીકળી	Out
લેનારા	Takers
મુખર્જી	Mukherjee
બકરી	goat
મંદીથી	from recession
દિપવીર	Deepveer
અભિનેત્રીઓએ	Actresses
સોંગે	Songe
મોનિકાની	Monica's
આપ્ટેએ	Apte
બિઝનેશ	Business
પ્લાસ્ટિકની	of plastic
અનોખી	Unique
સેલેબ	Celeb
સિલસિલો	Silsila
પ્રિંયકાનો	Priyanka's
તડકો	Sunshine
શાનદાર	Awesome
ડોકનો	Doc's
જ્વેલર્સનો	Of jewellers
પાર્ટીમાં	At the party
હાર્દિકની	Of Hardik
રોકનારાઓને	To the stoppers
સજા	Punishment
છેડતી	Teasing
ગુજરાતીઓ	Gujaratis
ભાગની	part
શકશે	can
કલાક	hour
10મા	10th
ચાવલાનું	Chawla's
વેચતા	Selling
ડાન્સનાં	of dance
11કરોડની	Rs 11 crore
રોલિંગ	Rolling
બાળકને	to the child
દોડી	Running
દશ	ten
ટ્રેનના	of the train
ઇનમાં	In in
કર્મચારીઓને	Employees
કાકા	Uncle
કેન્સલ	Canceled
ડાઉનલોડિંગ	Downloading
અક્ષરાની	Aksharani
જામ	Jam
ટ્રેલરની	of the trailer
રડવાનો	Crying
અભિ	Abhi
વ્યાજદરમાં	In interest rate
ચાર્જિસ	Charges
રસ્તો	road
એટીએમ	ATM
વખાણમાં	In praise
મેકઅપે	Make-up
દરિયામાં	At sea
ટ્રાન્સજેન્ડર	Transgender
મોંધવારી	Mondhwari
ચીરયૌવન	Chirayauvan
ચૂનો	lime
ટકાથી	percent
ચુકવાશે	will pay
સોનાલી	Sonali
દુબઈના	Of Dubai
કેબિનેટ	Cabinet
10250ની	10250
નિધનની	of death
સંઘર્ષ	Struggle
કક્કરને	To Kakkar
જીવનનું	Life's
પોઝથી	from pose
જોઇ	Saw
લેટર	Letter
બાદનો	The latter
કિંમતોએ	Prices
જયાપ્રદા	Jayaprada
ટ્રક	Truck
વેટનો	Wet's
રિસેપ્શનમાં	at the reception
ફેસબૂકમાં	In Facebook
આંતરરાષ્ટ્રીય	International
અસભ્ય	rude
નબળી	Weak
અક્ષયે	Akshay
ગેમ્સ	Games
માર્કેટને	to the market
કક્કડે	Kakkade
મુસ્લિમ	Muslim
હિના	Hina
ત્યારથી	Ever since
પ્રોસેસ	Process
726માં	In 726
બબાલ	Babbal
ખરીદશે	Will buy
શિયોમીનો	Xiaomi's
આરોપીઓને	accused
સારવાર	Treatment
ગેજેટને	to gadget
શકું	I can
ઐશ્વર્યા	Aishwarya
કરનારો	Doer
સરળતા	Ease
ટાટાનો	Tata's
પહોંચ્યું	arrived
નીતા	Nita
ગોઠવણ	Adjustments
ક્લિક	Click
ઠંડક	Cooling down
આખી	The whole
અર્જૂનનાં	Arjun's
કોઇ	Someone
રિમૂવ	Remove
આગવો	Next Up
રૂપિયો	rupee
છેતરપિંડીની	cheating
ગોલ્ડ	Gold
ઈશાના	Ishana
કમબેકની	Of a comeback
કોન્ડોમ	Condoms
ભલામણ	Recommendations
તબીબી	Medical
બ્રાવિયા	Bravia
સ્ટુડિયો	Studio
રહો	Stay on
સત્ર	Session
માંગતો	Wanting to
બ્લશ	Blush
6ની	of 6
ટિકિટનો	of the ticket
પાટીયા	Patiya
સંબંધમાં	In a relationship
મોંઘવારી	Inflation
60દિવસમાં	In 60 days
શુભેચ્છા	Best wishes
કલાકોનું	hours
પોર્ટ	Port
કાર્યવાહીથી	by proceedings
અરૂણ	Arun
માર્કેટની	of the market
વીમો	insurance
છોરીયાં	Chicks
વિસનગર	Visnagar
જોતા	Looking at
અસરઃ	Effect:
એક્ટ્રેસની	of the actress
ધૂત	Dhoot
જન્મ	Birth
આતંકવાદીઓએ	terrorists
ભવિષ્ય	The Future
અમારૂ	ours
વૂમન	Woman
થાઓ	Be
પટની	Patni
માતાને	Mother
શિખા	Shikha
સેક્સનાં	of sex
રવાના	Departure
હવેથી	From now on
ઘટાડવાની	To reduce
નવરાત્રિ	Navaratri
વાપર્યું	Used
સલમાનનું	Salman's
શરમજનક	Embarrassing
વેણુગોપાલના	Venugopal's
અંજનાસિંહ	Anjana Singh
કાળુનાણું	Black money
ટિવસ્ટ	Tweepst
માની	Mani
યોજાયો	Held
મર્ચન્ટ	Merchant
ત્રિપાઠી	Tripathi
છોડીને	Leaving
કેન્ટિનમાં	In the canteen
કાયમ	Forever
ચુસ્કી	Chuski
તોડવાની	To break
લાવવા	Fetch
હિરો	Hero
પત્રકાર	journalist
બંગાળી	Bengali
કાર્ડની	of the card
નવાઈ	Surprised
ત્રિવેદી	Trivedi
એડિટિંગ	Editing
ડોક્યુમેન્ટ્રી	Documentary
શેપ	Shape
બાબતમાં	In case
ફેમિલીને	To the family
10600ની	10600
જેક્લિનનાં	Of Jacqueline
આપવાનાં	to give
બોટમાં	In the boat
ન	No
બળવાખોર	Rebel
સેવાથી	from service
ગીતે	Geete
છેડતીનો	of molestation
દરવાજા	The doors
વિનતા	Vinta
ટેક્નોલોજી	Technology
સ્ટીવ	Steve
શાકભાજી	vegetable
ખુબસૂરતીને	To the beauty
રિસ્ક	Risk
લોન્ચ	Launch
94માં	In 94
રડવા	Crying
હસતા	Laughing
પોતે	Himself
વિરોધ	Protest
વડોદરાઃબાયોટોર	Vadodara: Biotor
શરમાવે	Shame on
ડોલરમાં	in dollars
પોલીસનો	of the police
ઓર્ટેલિયસને	To Ortelius
સમાજ	Society
સાતમું	seventh
બોટલ	Bottle
ઉગ્ર	fierce
છવાયેલી	covered
ગ્લોબ	Globe
મુન્ની	Munni
પટણી	Patni
સોલર	Solar
કરાવ્યું	Done
ચલાવી	Ran
મિનિટની	minutes
હિતેન	Hiten
ખોટો	Incorrect
ઓફ	Of
બુધવારે	On Wednesday
રહેમાનની	Rahman's
નેટ	Net
તમામ	All of it
ટ્વિટરથી	From Twitter
ચેટનો	Chat's
લલકાર	Lalkar
આર્યને	To Arya
અલગથી	separately
સીએમના	CM's
વધારીને	by increasing
એવેન્જર્સ	Avengers
બેબએ	Babe
મહોર	Mahor
શોનું	Of the show
એક્ટિવા	Activa
આદમીના	of the man
ક્યો	What?
ભટ્ટ	Bhatt
મળો	Meet
શકતી	could
બેપનાહ	Bepanah
પર	on
ભાડાના	Of Rent
અમાને	Amane
કોમર્સ	Commerce
રણબીરનું	Ranbir's
તેલ	oil
હીરા	Diamonds
ઇન્ફોસિસ	Infosys
ગુલ	Gul
એક્ટરને	To the actor
કાળજા	Kaalja
દર્શન	Darshan
સામેઃ	In front:
સેંસેશન	Sensation
કાર્લમેન	Carlman
કચેરીમાં	in the office
સુરક્ષા	Security
દિલથી	From the heart
સમાર્ટફોન	Smartphone
ચૂકતે	Pay off
નીચે	downwards
પાર્થિવદેહ	Parthivadeh
ઉડાવી	blown up
આયુષ્યમાન	Life expectancy
વેરા	Vera
વાયરસની	of the virus
કેટલીક	Some
ચકાશો	Check
પેકેજની	of the package
સુવિધા	Facility
મુકી	put on
હેઠળ	Under
જનારી	Janari
તબલા	tabla
શરમાઈ	Ashamed
જનારા	Goers
રાખનારી	Keeper
અમેરિકા	Americas
હોટ	Hot
તોડી	Broken
વધાર્યુ	increased
મોનાલિસા	Monalisa
બોસ	Boss
રેટવાળી	rated
લીધુ	Taken
ટ્રાન્સફરનો	Transfers
બોનાન્ઝા	Bonanza
હિટ	Hit
પ્લેન	Plane
દીધી	given
તુજે	You
ઈશાન	Ishaan
ખરીદ	Purchase
મીનિટોમાં	in minutes
ખોલી	Opened
31મી	31st
ખાતું	Accounts
મૂળની	of origin
ટોલગેટ	Tollgate
કરાવ્યો	done
બાઇક	Bike
શિલ્પા	Shilpa
કુમારના	Kumar's
ઇલિયાનાનો	Ileana's
નાખી	cast
અમરેલીના	Of Amreli
લાવી	Loaded
બેંકનાં	of the bank
નાખ્યાં	dropped
રફુચક્કર	Rafuchakkar
ગેસનું	of gas
12નો	of 12
પરંપરા	tradition
ફેમ	Fame
કવચ’	Kavach'
ડિફોલ્ટર્સ	Defaulters
ગ્રાન્ડ	Grand
લૂણ	Salt
દબાવતા	Pressing
વિક્ટોરિયા	Victoria
સિમ	Sim
સૌની	Of all
સમુંદર	Samundar
સર્ટી	Surty
દસકામાં	in decades
શાહરૂખથી	From Shah Rukh
જોડવામાં	In Connecting
ડિઝલ	Diesel
ક્યાંક	Somewhere
વખણાય	Praise
બ્રાન્ડેડ	Branded
કરિશ્માનો	Of Charisma
વધી	increased
મલાઇકાએ	Malaika
લોકલ	Local
પાથરીને	Pathri
થતાં	happening
નીતિ	Policy
2019ની	Of 2019
પૂનમ	Poonam
જેમ	Like
ટકાનો	percent
નારાયણની	Narayan's
ખતમ	Finished
કિસ્મત	Kismat
ફ્રોડઃ	Fraud:
સિરીયલના	Of the serial
કાર્ડના	of the card
એકઃ	One:
ઉત્પાદકોને	to manufacturers
વેરિએન્ટમાં	In variant
કરાયા	Done
લાઈવ	Live
ત્રણના	of three
વધુ	More
ખરીદવામાં	To buy
રોકી	Rocky
પાન	leaf
ખાંડથી	from sugar
ખન્નાએ	Khanna
ખાવા	To eat
કસોટી	Test
ગુલાટી	Gulati
લંબાઇ	Length
ધડકે	Banging
સોમવારે	On Monday
ખૂશી	Khushi
મેગાપિક્સલ	megapixels
હતુ	was
ચૂકતા	missing
પડશે	will have
લગાવવાનું	To install
ટકા	percent
બાસમતી	Basmati
અપ	Up
રણબીર	Ranbir
સ્વાદ	taste
સુબ્રત	Subrata
નહિ	No
બિનસબસિડીવાળાં	Unsubsidized
દાયકાની	of the decade
હોવાની	to be
ધરપકડથી	from arrest
સલમાન	Salman
જમા	Deposit
દેવો	Gods
બાયોગ્રાફી	Biography
નિફ્ટીએ	Nifty
માઈક્રોમેક્સનો	Micromax's
નેસ	Ness
બ્લુ	Blue
ક્રાંતિકારી	Revolutionary
મટકાવવા	To squeeze
નહોતી	Not
સ્ટ્રાઇકની	of strike
જોડાયેલી	Connected
કરિનાનો	Kareena's
બદલાયો	Changed
ખોલાવવો	Open
3નો	of 3
લેવાયા	Taken
રચશે	will create
શ્લોકાને	To Shloka
બેસી	Sit down
મલાઇકાના	Malaika's
સિંગતેલમાં	In Singtel
સલાહ	advice
ફ્રાંસને	To France
દિવાળી	Diwali
ઉતાર્યા	Offloaded
દૂધથી	with milk
કાયાના	Kayana
સેટિંગ્સમાં	In Settings
વારયલ	Waryal
કુમારસ્વામી	Kumaraswamy
સહમતીથી	by consent
પાછા	Back
મુંબઈ	Mumbai
પાછળની	Back
રેટિંગ	Rating
કોના	Whose
ઝાટકણી	Jhankal
સેરેમનીમાં	In the ceremony
દેણામાં	in debt
ઇન્સ્ટાગ્રામનું	Of Instagram
નાખુશ	Unhappy
જ્વેલ્સે	Jewels
કેઝ્યુઅલમાં	In casual
ભારતે	India
સીડી	CD
બેરોજગારને	To the unemployed
નિવેદન	Statement
દીકરો	Son
ઇફ્તાર	Iftar
કિંજલ	Kinjal
જેઠ	Jeth
સહયોગી	Associate
ફીચરથી	From the feature
સેમસંગે	Samsung
કરણી	Karani
ફ્યુચર	Future
આવિષ્કાર	Discovery
માથા	Head
થયુ	happened
વચગાળાનું	Interim
કોની	Connie
વુમન	Woman
4500માં	In 4500
મૃત્યું	death
ગાડીયોના	Gaadiyona
થોર	Thor
મુકતાંની	to put on
સમ્રાટ	Emperor
જીમની	Jim's
માઇક્રોસોફ્ટે	Microsoft
ઓછી	Less
એપ	App
ગાડીની	of the car
માતા	mother
પૂછ્યાં	Asked
કુમારની	Kumar's
સુધીનું	up to
મનાવશે	will be persuaded
નિશા	Nisha
ઓનસ્ક્રીન	Onscreen
જથ્થાબંધ	in bulk
બેજોસ	Bezos
પ્રકાશે	Light
ઈશાની	Ishani
લોન્ચુ	Launchu
શીખ્યો	Learned
શરૂઆતમાં	In the beginning
માધુરીની	Of Madhuri
ક્લિયર	Clear
અંતે	At the end
ફરો	Turn around
ક્રિકેટ	cricket
યૌન	Sexual
કારને	Car
વેઠવું	to suffer
બાળપણની	Of childhood
પ્રાઇવસી	Privacy
રિતિક	Hrithik
એવોર્ડનાં	Awards
બુલેટ	Bullet
થયાં	happened
પૈસાથી	with money
ટ્રેલર	Trailer
ભાષા	language
હિરોઇનનો	of the heroine
ઈન્ડીયાના	India's
પસ્તાય	Repentant
બીના	Bina
આમાં	In this
સિંહને	to the lion
પરિધાન	Dress
ફિંગરપ્રિન્ટને	fingerprint
સગાઇ	Engagement
4900નું	Of 4900
મહેતામાં	In Mehta
ભાજપના	BJP
ગુજરાતે	In Gujarat
મંગેશકર	Mangeshkar
કોલ્સ	Calls
શાહિદની	Shahid's
સહકારની	Of cooperation
આપઘાત	Suicide
સેમ	Sam
શાકભાજીના	Vegetables
સિદ્ધુએ	Sidhu
ધમાકેદાર	Bang on
ફિચર્સવાળા	With features
ભારતીયોને	To The Indians
ઓન	On
માંગતી	Asking for
લગાવશે	will impose
આમિરે	Aamir
ચોપડા	Chopra
તરીકે	as
એટલો	So much so
સેલ	Cell
શોધવા	To find
હજારે	Hazare
મહાનુભાવનો	Of the dignitaries
તહેવાર	festival
હિઝબુલના	Of Hizbul
પ્રશ્નનો	Question
મહત્વનો	Important
થોથર	Thother
પછાડ્યુ	Knocked down
કરાવશો	Get it done
સુરતથી	From Surat
જવાબ	reply
બેંકની	of the bank
પેઈડ	Paid
પી	P
લાગ્યો	felt
ટાટાને	To The Tatas
વિલયની	Vilayne
વિમાન	aeroplane
સ્કૂટર્સ	Scooters
જનતાની	of the public
ડીઝલ	Diesel
ગ્રેચ્યુઇટીની	of gratuity
બિટકોઈન	Bitcoin
કિંમતનાં	Of Value
દાયરામાંથી	from Daira
કીમત	Price
500થી	From 500
મસ્કએ	Musk
સ્ટેશનો	Stations
મોટરસાઈકલ	motorcycle
મીડિયાની	of the media
આપણે	We
ગુજરાતના	Gujarat
અવતારે	Avatare
ઇન્વેસ્ટ	Invest
તગડી	Tagadi
નજીક	near
રિઝર્વ	Reserve
સુધારશે	Will update
સેમસંગ	Samsung
પામી	Pami
તસવીર	Picture
ઉભી	Stand up
ઇન્ટેક્સ	Intex
સૈફીનાની	Saifina's
શારિરીક	physical
જોઈએ	Let's see
સ્ટાર્ટઅપ	Startup
અર્થવ્યવસ્થા	Economy
ઉડાવ્યા	flew
તરત	instantly
સાડીમાં	In a saree
ક્લાસમાં	In class
રામલીલા	Ramlila
સરસ	Nice
મોકલવામાં	Sent in
ભરપાઇ	Reimbursement
75ની	Of 75
જોડતા	Connecting
પડેલા	Lying down
આઇટીની	OF IT
મોટાભાગ	Mostly
શેરબજારમાં	On the stock market
ફાયદોઃઅમૂલ	Benefit: Amul
જીવનભર	A lifetime
કુંડલી	Horoscope
ઈન્ડીયાનું	Of India
મહત્વકાંક્ષી	Ambitious
લગાવ્યા	Put up
ઉતરી	Alighted
8000માં	In 8000
ફાઇલ	File
નામાંકનમાં	In nominations
અનુ	Anu
સેનની	Sen's
75માં	In 75
ઉતાર્યુ	Taken down
ફેસલિફ્ટ	Facelift
પુછ્યા	Asked
કરીનાનો	Kareena's
તારા	Yours
શુક્રવારથી	From Friday
75ના	75
અહી	Here
ચોપરાના	Chopra's
હિંમતનગરઃશાકભાજીના	Himmatnagar: Vegetables
વર્ગના	Class
મિમોહે	Mimohe
રાખવું	Keep
પ્રવાસે	On a tour
જ્હાન્વી	Janhvi
જીતેલી	Won
સેન્સેશન	Sensation
ઊંઘ	Sleep
ભાડા	Rent
સિસ્ટમમાં	in the system
વધાર્યું	Increased
આપ્ટેની	Apte's
માર્કેટ	Market
કેટરિનાથી	From Katrina
લેવાય	Taken
ધક્કો	Push
જિમમાં	In the gym
કરાવ્યુ	done
કાર્સ	Cars
ભાગીને	Running away
ટિપ્પણી	Comment
ટ્રેનનું	of the train
બેન્ડની	Of the band
રેડકાર્પેટ	Red carpet
કન્ટેસ્ટન્ટ	Contestant
વાહિયાત	absurd
લેતાં	Taking
ફ્રેમવર્ક	Framework
ન્હોતી	Not
યૂરોપીય	European
બંગલા	Bungalow
આસાર	Asar
ઉડ્ડયન	Aviation
પરવડે	Affordable
ઠાકોર	Thakor
આલિયા	Alia
ટૂંક	Short
વાતથી	By talk
રૂપિયાથી	With rupees
બનશો	Will be
મુમતાઝની	Mumtaz
બીમાર	ill
અંદરની	Inside
હાસલ	Hassle
વાઇબ્રન્ટ	Vibrant
કેસ	Case
ઠેર	There
ઘટ્યો	Decreased
પડાશે	will fall
મસ્તીભરેલી	Fun-filled
વેપારી	Merchant
ઇનસ્ટાગ્રામ	Instagram
એઝાઝ	Ajaz
ઓઇલ	Oil
મેંટલ	Mental
અરમાન	Arman
દરો	Rates
ઐશ્વર્યાએ	Aishwarya
સલૌનની	Salon
વિશેષતા	Features
માગતો	Asking for
સાફ	open
કમાન્ડ	Command
જીતો	Win
કામ	act
માફીથી	Apologetically
નીકળ્યા	out
સ્‍થપાશેઃકેવી	Will settle: KV
ક્યાં	where
શહીદ	Martyrs
સ્વીકાર્યું	Accepted
સતત	Continuous
ફિદા	Fida
બાહુબલીની	Of Baahubali
બહેનો	Sisters
જલ્દી	Soon
શીખવાડી	Teaching
એકતા	Unity
સિંઘનાં	Singh's
શોષણની	of exploitation
ધાબળો	blankets
ફ્લાઇટનાં	of the flight
કોન્ટીનેન્ટ્સનો	Of the continents
ઝકરબર્ગે	Zuckerberg
સિલેન્ડર	Cylinder
લાખોનું	of millions
સંદીપ	Sandeep
આનંદે	Joy
શ્રીદેવી	Sridevi
થતી	happening
મોકલે	Send
હસિનાઓ	Hasinao
ઇનકમ	Income
લકઝુયર્સ	Luxeurs
વિલીન	Willin
કોપી	Copy
વાસણ	pot
ધોનીનું	Dhoni's
પેરિસમાં	in Paris
શખ્સના	the man's
પડતા	falling
સ્પીચ	Speech
તાપસીની	Taapsee's
લુછતો	stealing
મચી	Machi
ડિસેમ્બરથી	From December
ભાઈબંધી	Siblings
તિવારીની	Tiwari's
ધડ઼કનું	of a bang
શોષણનાં	of exploitation
સાયરા	Saira
પરિસ્થિતિમાં	In a situation
ગ્રાહકોનો	of customers
સંભાવનાઃજેટલી	Probability: As much as
એપિસોડ	Episode
દુખાવો	Pain
સીઓઓના	COO's
છેતરપિંડી	deceit
ભરૂચમાં	in Bharuch
અવોર્ડથી	From the award
મલ્લિકાની	Mallika's
સૂરમાં’	In tune'
બાલને	Balne
ફેવરેઇટ	Favreit
વિમાનનું	of the plane
સ્ટોક	Stock
દમ	asthma
ગુજરાતનો	Of Gujarat
દેખાયા	appeared
વ્યવહાર	Transaction
હાઇકોર્ટનો	of the High Court
મ્યુનિ	Muni
એપલનો	Of Apple
નાચ્યાં	Danced
ફન્ડમાં	In fund
બાસુ	Basu
એફમાંથી	from F
યોન	Yon
રિતિકની	Of Hrithik
ભૂલથી	By mistake
ધિરાણ	Credit
જનમતમાં	in the referendum
સામે	in front of
રિસેપ્શનની	of the reception
બિકિનીને	To the bikini
અમૂલના	Amul's
ફસાયેલી	Trapped
જામી	Jami
વીરમદેવી	Veeramdevi
ચંદ્રમુખી	Chandramukhi
મેસેજથી	from the message
પ્રકારના	Type of
સ્કેન્ડલમાં	In scandal
શેર	Shares
હસીને	Smiling
તારીખનો	Date
જલદીથી	Soon
ખાસિયતો	Features
90નાં	Of 90
છાશવારે	Chhashware
હેકિંગ	Hacking
બાલીનું	Of Bali
શરૂઆતની	Of Startup
ટચ	Touch
સવાલ	question
સાગરની	of the sea
મોસ્ટ	Most
ટાવર	Tower
દેશનો	of the country
એલિજિબલ	Eligible
પુલવામામાં	in Pulwama
લિયોનીએ	Leonie
કમાવવા	To earn
ચેડા	Tampering
વાંચી	Read
ફાઇનાન્સ	Finance
લગ્નનું	of marriage
રસમની	Rasamni
બેલે	Belle
બાળકો	Children
ચેટિંગ	Chatting
મોકલાઇ	Sent
16મીથી	From 16th
એર	Air
ડુઈંગ	Doing Doing
જિમ	Jim
ખતરામાં	in danger
શંકર	Shankar
ધમાકો	Explosion
મહેનત	Hard work
સાઈઝ	Size
ફ્લાઇટ	Flight
અન્ય	another
સમગ્ર	Throughout
મલાઇકાની	Malaika's
કરાય	done
ઈજા	Injury
ગણિત	mathematics
ગુસ્સા	Anger
ટ્વિંકલ	Twinkle
ભુતાન	Bhutan
બેસિક્સ	Basics
પુરુ	Puru
ખરીદનારાઓ	Buyers
પકડે	catch
ગેલેક્સી	Galaxy
સ્લેબમાં	In slab
આફરીન	Afrin
સિરિયલ	Serial
સહિતની	including
પ્રેગ્નેન્સીની	of pregnancy
રોમાંચ	Thrill
નિયમોનો	of the rules
ક્લોન	Clone
શર્માનો	Sharma's
કૉમર્સ	Commerce
મીટર	meter
વાપરવાની	To use
સેને	Sene
માણવાં	to enjoy
લંચ	Lunch
સળિયા	rod
ડિટેલ્સ	Details
સુવિધાઓથી	From the facilities
વાગ્યે	at noon
બદલી	Change
એક	One
વીંટી	Ring
નેહાનું	Neha's
સિદ્ધુનું	Of Sidhu
કેમેસ્ટ્રી	Chemistry
કપિલ	Kapil
વોઇસ	Voice
પુરવઠા	Supplies
ફગાવ્યા	Rejected
કોઈ	Someone
ઘરમાં	At home
બાળકી	Baby girl
પીઠીની	Pithi's
હસવા	Laughing
દાઢી	beard
પ્રમુખની	President's
થશે	Will be
વધારા	Extra
સર્વિસનો	of service
બલેનો	Baleno
વિવાદ	Controversy
ચૂકવવાનો	To pay
નામનું	Name
શાહરૂખની	Shah Rukh's
સમર્પિત	Dedicated
ક્યાંથી	Where from
બેગણો	Double
સ્નેપચેટની	Snapchat
ભોજપુરી	Bhojpuri
જવાનોને	to the jawans
ઇન્ડિયન	Indian
ફેસબૂકનો	Of Facebook
શ્લોકાના	Shloka's
ખોલાશે	Will open
કવિતા	Poetry
પૂછ્યો	Asked
માગતા	Asking for
પત્રકારોને	To journalists
દવા	medicine
મજુરો	Workers
કારનો	of the car
ન્યુક્લિયર	Nuclear
નરનારાયણ	Narnarayan
બધી	All
10360ની	10360 of
નોટબંધીનો	of demonetisation
વાઇલ્ડ	Wild
પીડા	pain
બચત	Savings
શહીદો	Martyrs
સૈફીના	Saifina
વીડિયોમાં	In the video
મેંમર્સને	To Memmers
પ્રકાશને	to the light
અર્થવ્યવસ્થાને	to the economy
વસ્તી	Population
મર્ડરથી	From Murder
કાઉચ	Couch
પેલેસ	Palace
જીશૂ	Jishu
ફુલહાર	Phulhar
વોડાફોન	Vodafone
સાંભળીને	Listening to
ગજ્જરે	Gajjare
કેન્સરની	Cancer
ટોલ	Toll
શ્રાવણમાં	In Shravan
ટોપબ્રાંડની	Topbrand's
કરોડથી	crore
પ્રમાણિકતાથી	Honestly
મોડલ્સ	Models
ગણતરીનાં	Counting
ચાલનાર	Walker
બાગી	Baagi
ફોટોગ્રાફીનો	Photography
ખન્નાનું	Khanna's
હેન્ડસમ	Handsome
લાગતા	looks like
સ્ટીકર	Sticker
તારીખથી	From date
મિનિસ્ટરઃ	Minister:
દેસી	Desi
કપૂરની	Kapoor
અત્યારે	Right now
ઈલેક્ટ્રિક	Electric
પ્રત્યાર્પણ	Extradition
પ્રિયાને	To Priya
કુંડળી	Horoscope
સસ્તુ	Cheap
ગીતાંજલિ	Geetanjali
કચરામાંથી	from the garbage
ઉદ્યોગને	to the industry
મણિકર્ણિકાના	Manikarnika's
તૂટેલી	Broken
અનુષ્કાએ	Anushka
વાયદો	Promises
2019માં	In 2019
સુરંગમાં	in the tunnel
બળાત્કારનો	of rape
કરણનાં	Karan's
પહેરવા	To wear
ઇલાજ	remedy
ફિલ્મોનાં	Of films
ફ્રાંસના	Of France
નાગરિકોએ	citizens
આનંદીબેન	Anandiben
ડાયરેક્ટર	Director
ફિટનેસ	Fitness
સિદ્ધાર્થ	Siddhartha
સ્ટાઈલ	Style
વીતી	passed by
પુત્રી	daughter
પોલ	Paul
ઉઠાવ્યું	picked up
વાલ્મીકિ	Valmiki
121માં	In 121
વકર્યોઃ	Wakaryo:
ચેકબૂક	Checkbook
બેંકિંગમાં	In Banking
કેશનું	of cache
પૉલિસી	Policy
બોલાવે	Call
ડિસેમ્બર	December
સારાનું	of good
તસવીરમાં	In the picture
વિભાગે	Department
બનવાની	to become
એકાઉન્ટમાંથી	from the account
ડેનિયલના	Daniel's
ફંડનું	of the fund
શ્રીનાં	Shrina
કૃષ્ણા	Krishna
વાંચીને	By reading
તૂટી	Broken
કરવાચોથનું	Of Karwa chauth
રોકાણનું	of investment
વિચારી	Think
હેકર્સે	hackers
ઝટકો	Jolt
માર્કલના	Of Markle
સફળતાઃ	Success:
સ્પાઇડર	Spider
સવારથી	Since morning
સ્ટેન	Stan
ફ્રિક	Frick
એક્સક્લુસિવ	Exclusive
વિદ્યા	Vidya
ઈન્ક્મટેક્સ	Income Tax
ફોટોગ્રાફ્સ	Photographs
શ્રોફની	Shroff's
પપ્પા	Dad
જયતે	Jayate
ટાટાની	Tata's
પરણશે	will get married
કરિશ્માએ	Karishma
રોયની	Roy's
રિકવર	Recovery
બપ્પી	Bappi
સુદામા	Sudama
શોને	To the show
ઘણીવાર	Often times
કતલ	Slaughter
અરબોની	Arboni
દેનારી	Denery
મોઘુ	Moghu
250થી	From 250
ઉજવણીઃ	Celebration:
વ્યાપારમાં	In business
મિલકતો	Properties
2018ની	Of 2018
ફેલાવો	Spread
10460ની	10460
કૌશલથી	From Kaushal
બાંધી	tied up
પરિવારોને	to families
મીઠાના	Salt
અનુસરી	Following
ઇન્ડિયાનાં	Of India
એકશનમાં	In action
સિરીયલનો	of the serial
હાથની	Hand's
ચંદા	Chanda
વ્યક્ત	Expressed
સન્માન	Honors
પ્રભુ	Lord
વડોદરામાં	In Vadodara
સંકટમાં	in crisis
પન્નુ	Pannu
વિરાટનું	Of Virat
ફેને	Fenne
નોંધાવી	Filed
ચહેરા	Faces
કેવાં	How about
બીએ	BA
પતંજલિનું	Of Patanjali
નિવૃત્તિની	of retirement
મધ્યમવર્ગનાં	Middle class
ચુકવવાનો	To pay
કેક	cake
નિકની	Nick's
અનાજ	Grains
જીએસટી	GST
અંગૂઠો	thumb
આલિયાનો	Of Alia
ગુડગાંવમાં	in Gurgaon
કેમેરો	Camera
એડ્રેસ	Address
તમારુ	Yours
બિહુ	Bihu
પહોચ્યાં	arrived
સિતારાઓએ	Stars
ચિદમ્બરમ	Chidambaram
જન્મે	by birth
ચોર્યા	stolen
રશ્મી	Rashmi
જેલમુક્તિ	Release from jail
મહાનાયકને	To the great hero
તેના	his
રોક્યા	Stopped
દુપટ્ટો	Dupattas
એમ્બેસેડર	Ambassador
દિલ્હીમાં	In Delhi
પ્રેમ	Love
સ્પર્ધા	Competition
કિન્નર	Kinnar
ગણતરીના	Counting
રફ્તાર	Raftaar
આંગળીઓ	Fingers
પ્રાઇવેટ	Private
સ્ટારને	to the star
350નો	Of 350
સુવાનું	Sleeping
હાલાકી	Halaki
જવેલર્સમાં	In Jewelers
નાનકડા	Small
પહેરવાનું	To wear
ગુફામાં	in the cave
પિચાઇએ	Pichai
બેન્કમાં	In the bank
પાર	across
અફવાઓને	Rumors
હિરા	Hira
ઇન્સ્ટન્ટ	Instant
જીમ	Jim
મહિને	Monthly
કંપનીને	Company
ભાદુરી	Bhaduri
કિલોનો	of kilograms
ડોટ	Dot
ખેડૂતોમાં	among farmers
પ્રેંક	Prank
સેટઅપ	Setup
હરાજીમાં	At auction
વર્ષગાંઠ	Anniversary
બચાવો	Save
કૌભાંડી	Scamster
10999માં	In 1099
ઇન્શ્યોરન્સના	Of Insurance
હ્યુન્ડાઇ	Hyundai
શોકમાં	in mourning
ચોપરા	Chopra
સિસ્ટમ	System
હેલમેટ	Helmet
ભાભીજીનું	Sister-in-law's
ઝકરબર્ગ	Zuckerberg
કેરટેકર	Caretaker
આરોપથી	from the charge
રાતો	Nights
મેસેન્જરથી	From Messenger
કલ	Call
ગ્રુપમાં	In group
ડોનર	Donner
નેટવર્કથી	From the network
સાડીની	of the sari
કરોડનુ	crore
તાજા	Fresh
ઇન્ડીયાની	Of India
ટ્રિબ્યૂટ	Tribute
શુક્રવારે	On Friday
લોકેશન	Location
આદાબ	Adab
લેવું	To take
પાણીના	Water
પાયાવિહોણા	baseless
ભરી	Filled up
નહીં	No
ગુસ્સાનો	of anger
કપાતાં	cutting
સર્જિકલ	Surgical
અસલ	The original
ટ્વિટરે	Twitter
લોકસભાની	Lok Sabha
કરવી	To do
ચહેરાથી	from the face
ઉઠાવતા	Picking up
સ્ટાન્ડર્ડ	Standard
બદલવાની	To change
હંફાવામાં	In a frenzy
ઉજાલા	Ujala
20ને	20
બંગાળ	Bengal
યાદવને	To Yadav
જી	G
બાલન	Balan
કલાકની	hours
મનમર્ઝિયા	Manmarzia
દુશ્મન	enemy
ટિપ્સ	Tips
અનૂપ	Anup
અમજદ	Amjad
બાયોપિકમાં	In the biopic
પ્રોવિડન્ટ	Provident
રેપર	Rapper
ખોલ્યાં	Opened
ડુઇંગ	Doing
બિલ્લી	Billy
લોડેડ	Loaded
ડાયટિંગ	Dieting
ટેક્સી	Taxi Taxi
ઈન્ડ	Ind
હાઇટેક	Hi-Tech
વર્ષની	year
એવા	Such as
પતાવટનો	Settlement
દીશા	Disha
કરનારા	Doers
વીડિયોની	of the video
સમયસર	On time
વાઇબ	Vibe
ખોલાયા	Opened
સંજયની	Sanjay's
સુપ્રીમમાં	In the Supreme Court
મેનેજરની	Manager's
રોમેન્ટિક	Romantic
વિરુદ્ધ	against
પ્રોડક્ટ	Product
જેની	Whose
સોફિયા	Sophia
પાગલ	Mad
નિગમે	Corporation
રનૌટે	Ranout
તનુશ્રીને	To Tanushree
સ્ટેચ્યુ	Statue
પીને	Drink
વાપસી	Back
ભડક્યા	provoked
ચિપ	Chip
બિચ	Beech
2નું	of 2
3000સુવર્ણકારોના	3000 of the goldsmiths
સિડાન	Sedan
રેસિપીના	Recipes
કાપે	Cut
ડિરેક્ટરે	Director
તમામની	of all
જાહેરાતો	Ads
નામાકિંત	Namakint
ગ્રામ	gram
ફિક્સડ	Fixed
વન	forest
મીઠું	salt
હૉલ	Hall
2022માં	In 2022
પ્રથમ	first
કરાવશે	Will get it done
સિનેમામાં	In cinema
સીરિઝ	Series
નારો	Naro
2020થી	From 2020
વાપરે	Use
બ્લેકબેરીએ	BlackBerry
ગાડી	Car
અંદરથી	From inside
પ્લે	Play
પ્લેને‘બેસ્ટ	Plane's Best
કોમેન્ટ	Comment
રજનીકાંતની	Rajinikanth's
સર્કિટનાં	Of the circuit
1બી	1B
ન્યાસા	Nysa
ભોગ	Victim
ફફડાટ	Fluttering
જોજો	See
મીડિયમ	Medium
હું	I
લિંક	Link
ગેમમાં	In the game
હોટનેસનો	of hotness
ઠગી	Cheated
ટ્રાન્સપોર્ટ	Transport
મર્ણિકર્ણિકાના	Of Manikarnika
સેક્સી	Sexy
મેદાન	park
કીર્તિ	Fame
77માં	In 77
ઝડપાયું	Caught
બંગ્લામાં	In The Bungalow
લાફો	Lafoe
નોકરિયાત	job
રાજીનામા	Resignation
વેરાન	Veran
એપ્રિલના	April
દોરી	Lead
સ્થળને	to the place
ટ્રાન્જેક્શન	Transactions
વ્યક્તિએ	person
અટકાવવા	To stop
માગે	Ask for
સિરીઝ	Series
બલ્બ	Bulb
કહેવાય	It is said
સ્પર્શી	touching
વેગ	Velocity
જેનિફર	Jennifer
સાવકા	step-by-step
ટક્કર	Collision
ફોર્મ્યૂલા	Formula
ટોલનાકાને	Tolnaka
લોટપોટ	Lotpot
ડિલ્સ	Deals
ગ્રોવર	Grover
છેઃઆનંદીબહેન	: Anandiben
પ્રમુખ	President
કહ્યુંઃજુવો	He said: Look
રાધિકાનો	Radhika's
ધનકુબેરનાં	Dhankuber's
હાઇસ	Hais
લીધું	Taken
બેબી	Baby
દુકાનદારને	to the shopkeeper
ડેનિમ	Denim
ભીડની	of the crowd
ગણો	Count
ડિસેમ્બરમાં	In December
અટક્યો	Paused
ગ્રુપના	Group
અંબાણીનાં	Ambani's
50મી	50th
પ્રિય	Dear
આજની	Today's
આજીવન	Lifelong
ડ્રેસિંગ	Dressing up
ની	of
ફેલાવી	spread
સંબંધો	Relationships
ડ્રિક્સ	Drinks
કબજો	Possession
ખોરવાયું	Lost
સજાવ્યું	Decorated
યોગી	Yogi
શોમાં	On the show
ફિચર્સમાં	In Features
તેમનો	Theirs
રિશિ	Rishi
પેટ્રોલનો	of petrol
શિક્ષકને	to the teacher
મચાવે	creating
ફાલતૂમાં	In Faltu
લોકપ્રિયતા	popularity
બાદની	The latter
મુદ્દે	On the issue
કપાસનો	of cotton
થશો	Will be
જાન્યુઆરીથી	From January
ક્વીન	Queen
ફોર્મ્યુલા	Formula
વહેલી	Early on
ઉદયઃ	Uday:
મારુતિ	Maruti
સેરેમની	Ceremony
જૅમ	Jam
બોર્ડની	Of the Board
વોટર	Water
બચો	Survive
એરપોર્ટની	of the airport
આઇટીનું	OF IT
વેડિંગકાર્ડ	WeddingCard
હસિનાઓવાળા	Hasinaowale
ગાળો	Abuse
પૉઈન્ટનો	Point's
ફ્લેટ	Flat
કોમોલિકાનો	Komolika's
ઘરોના	of houses
કરવામાં	to do
કિસ્સામાં	In case of
લાઈનો	Lines
ખફા	Khafa
ડિશનો	Dishes
ગુસ્સો	anger
ઉમેદવારોએ	Candidates
40ની	Of 40
અઠવાડિયાથી	for weeks
હા	Yes man
ટ્રોલર્સને	Trollers
લેવાઇ	Taken
દુખ	grief
દુકાનકાર	shopkeeper
સાજિદની	Sajid's
જીંદગીના	of life
ચેન	Chen
આદિત્યનું	Of Aditya
બોલ્ડનેસની	of boldness
શુગર	Sugar
પેટ્રોલ	gasoline
કાર્દિશિયને	To Kardashian
છોકરીને	to the girl
ટકાના	percent
કમેન્ટ	Comment
સફેદ	White
મેમ્બરને	To The Member
પેન્શન	Pension
ઝઝૂમી	Jzoori
દીપિકાએ	Deepika
વિજયપતિ	Vijayapati
કપ	Cup
ભાવ1800	Price1800
સૌંદર્યાની	Soundarya's
બનીને	by becoming
મોંઘવારીનું	of inflation
ટ્રેડીશનલ	Traditional
દિવ્યાંકા	Divyanka
મર્સિડિઝ	Mercedes
અદાઓ	Adao
સાંજે	in the evening
વાઈબ્રન્ટમાં	In Vibrant
થાણે	Thane
સિન્થેટિક	Synthetic
સમંદર	Samandar
ચૌધરીનો	Chaudhary's
દર્શકોએ	Viewers
કેવુ	How about
રિતીકનો	Hrithik's
યશના	Yashna
નાગિન	Nagin
પટાવાળાની	of the patawala
તાપસી	Taapsee
મોર્ડલ	Mordal
દીકરીને	to the daughter
પાંડેએ	Pandey
પકડાઈ	Caught
રાજપૂતની	Rajput's
બાહુપાશમાં	In Bahupash
ટિકીટો	Tickets
નાંખી	cast
વેન્ટિલેટર	Ventilator
જોવા	Look at
ખૂલી	Open
શ્રદ્ધાંજલિ	Tributes
સંકળાયેલી	Associated
મનોજ	Manoj
સિનેમાના	of cinema
ત્વરિત	Instant
લગ્ન	marriage
2000ની	of 2000
ચક્કાજામ	Chakkajam
ડિગ્રીમાં	in degree
વ્યસ્ત	Busy
ડાટા	Data
સેક્સિએસ્ટ	Sexiest
માર્ચ	March
15કિલોના	15kilona
વાંધાનજક	objectionable
મુકાબલે	in comparison
અભિનેત્રીને	To the actress
શક્ય	Possible
લોકાએ	Loka
હારેડા	Hareda
જોવાયો	Viewed
જેને	to whom
સુઘી	Sughi
ઇટલીથી	From Italy
ખોટ	Loss
કમાનાર	Earner
ફંડ	Fund
દોર	Thread
ફ્રોડ	Fraud
પાડોશીઓએ	Neighbors
હલ	Hall
કડવા	Bitter
વોટ્સએપનો	Of WhatsApp
સુપર	Super
ચીડાવતા	Teasing
જીતીને	By winning
વેચનાર	Seller
જવેલર્સની	Of jewelers
કારના	Car's
રાવની	Rao's
વસાવો	Settle down
સિટીમાં	in the city
ઠાઠ	That's it
ફોટોશૂટ	Photo shoot
ડયુટીનો	Dutino
મોટાં	Big
દખલ	Interference
ઘરથી	From home
એરસેલ	Aircel
થયું	Happened
શીખામણ	Teaching
મધ્યમ	moderate
ચૂડા	Chuda
નિર્માણ	Construction
મુન્નાભાઈ	Munnabhai
હેર	Hare
ઉછાળો	Bouncing
અવશ્ય	Of course
નેક્સ્ટ	Next
હાથે	By hand
ટ્રાન્સફરની	of transfer
સાસુ	Mother-in-law
બ્લેકમેલર	Blackmailer
વરને	To the groom
સુધાર્યું	Updated
એટલે	So
ચોપરાએ	Chopra
કુલ	Total
પાયલ	Payal
બાળકોને	Children
અબરામ	AbRam
ચોપરાનાં	Chopra's
બોલ્યા	Spoke
મોતઃ	Death:
જવા	To go
બિલિયન	Billion
ગર્લફ્રેન્ડ	Girlfriend
ભારતી	Bharti
વર્ષભરમાં	throughout the year
ત્રીજા	The third
બેરોજગારીએ	Unemployment
ફિસ	Fiss
સભ્યપદેથી	from the membership
તડકા	Tadka
પખવાડિયામાં	in a fortnight
આપનાર	Giver
તમારૂ	Yours
લંડનની	Of London
સ્માર્ટફોન	Smartphone
ફિટ	Fit
તેને	To him
નેતાઓ	Leaders
ઝીનત	Zeenat
મોતનું	of death
હેપ્પી	Happy
ટૂ	Tow
ઇવેન્ટ	Event
નિરસ	Dull
નશો	Intoxicated
ડોન	Don
એક્ટ્રેસના	Of the actress
છોડ્યો	Left
વૈભવ	Luxury
અપગ્રેડ	Upgrade
રામાનંદ	Ramanand
ગૈલેક્સી	Galaxy
ભ્રમમાં	in illusion
એકવાર	Once upon a time
સ્પાઇસજેટનો	SpiceJet's
ફિચરનો	Feature
આઉટફીટમાં	In the outfit
લેખકનો	Of the author
ગજબનું	Amazing
બીજે	Other
પરેશાની	Trouble
સે	Se
સ્ટોર	Store
પગનું	of the feet
પેસ	Pace
જવાબદારી	accountability
ઈન્‍સ્ટાગ્રામનું	Of Instagram
બજાજ	Bajaj
હટવાના	To move
દિવાળીની	Of Diwali
કરવું	perform
ઘટાડા	Decline
ગ્રાહકો	Customers
સુપ્રીમે	Supreme Court
અગ્રેસર	Leading
રૂમ	Room
અમિષા	Ameesha
સપોર્ટ	Support
શેખર	Shekhar
મેળવશો	Receive
ફંડ્સથી	from funds
તુસાદમાં	In Tussauds
મૅગઝીન	Magazine
પસંદગીમાં	In selection
કાસ	Cass
દૂધના	of milk
સુરેન્દ્રનગરઃપોલીસ	Surendranagar: Police
છુપાયેલ	Hidden
ચુપકે	Chupke
કાર્ડઃ	Card:
ભાગેડું	Fugitive
બપોરે	in the afternoon
સસ્તી	Cheap
મારૂ	mine
અરોરાનો	Arora's
સુરતઃસુમુલ	Surat: Sumul
કંકુ	Kanku
બીજું	other
ગ્લોબલ	Global
ટેપ	Tape
સિરીઝના	of the series
માણસે	Man
આસાન	Easy
રિસેપ્શન	Reception
કર્ણાટકનાં	Of Karnataka
50ના	50
ગોવિંદા	Govinda
ચૌટાલાએ	Chautala
એક્ટરની	Of the actor
વિજળીના	of electricity
મુક્તિઃ	Liberation:
કોફીથી	From coffee
સપનાનું	of the dream
દેવું	Debt
મિલાનમાં	in Milan
બદલાવી	Change
છવાયેલો	covered
ધૂપિયાએ	Dhupiyya
સ્કીમ	Scheme
કીંમતના	Of price
સ્વયંવર	Swayamvar
જનતાને	to the public
કન્ટેસ્ટંટ	Contestant
પંચોલીએ	Pancholi
શિખામણ	Teaching
જીનીંગ	Ginning
હિન્દીમાં	In Hindi
એમેઝોન	Amazon
ખૂબ	A lot
પ્રાઇમ	Prime
ઇંધણમાં	in fuel
મળતો	Found
પ્રદુષણ	Pollution
અડધા	Half
હિરોઇન	Heroine
ઇટલી	Italy
વધારવા	To increase
ઉકળી	boiled
મ્યૂચુઅલ	Mutual
એલિયન	Aliens
છુ	I am
પ્રાઈવેસી	Privacy
સટ્ટામાં	In betting
આપશે	will give
આપો	Give
હાર્યા	Lost
સાક્ષીએ	The witness
નણંદ	Sister in Law
નખત્રાણામાં	In Nakhtrana
શ્રીરામ	Shri Ram
રહ્યાં	Stayed on
સેમસંગના	Samsung's
વધારવાની	To increase
પ્રિમિયરમાં	In premiere
મ્યુ	Mu
એપિસોડમાં	In the episode
કેન્દ્ર	Centre
એપ્રિલમાં	in April
રેશિયો	Ratio
ઢાઈ	Dhai
કૈફની	Kaif's
ગોસ્વામીનું	Goswami's
અહીંયાથી	From here
ભરે	Fill in
પારણું	Parana
બદલાઈ	changed
પરવાનગી	Permission
નાં	No
કોફી	Coffee
સેલની	Cell's
જઇ	Go on
જ્ઞાનમય	Enlightened
વગરના	Without
ઘેરાઇ	Gherai
યુઝર્સને	To the users
સંસ્કાર	Rites
બટન	button
ગાળી	Filter
મુસાફરી	Travel
પ્રોટેક્શનનો	Protection of
ફરાહ	Farah
અલગ	distinct
ટૉર્ન	Torn
બેટરીથી	from the battery
માન્ય	Valid
ખરીદવું	buy
સૈફના	Saif's
પલટવાર	Turnaround
ઇન્ડિયા	India
આહુજાની	Ahuja's
શોની	Show's
સ્પષ્ટતા	Clarity
મેક્સ	Max
વેટ	Vat
તાજમહેલ	Taj Mahal
મહુધા	Mahudha
છલાંગ	Leaping
આવવાના	to come
કળા	Art
હથેળીમાં	in the palm
કરાયો	Done
દેશનું	of the country
ગૌમૂત્રમાંથી	From cow urine
ઉપવાસ	Fasting
માએ	Mother
ગળામાં	in the neck
પછી	Then
ચિંતિત	Worried
જેનું	whose
પાયો	Foundation
કરાવેલ	Done
એક્ટ્રેસીસની	Of actresses
પ્રિયંકાને	To Priyanka
વિકાસે	Development
પાટેકરે	Patekar
હિરોઇને	Heroine
ડેલોઇટના	Deloitte's
છે	is
સફળ	Successful
પોસ્ટનો	of the post
સેન્‍ટરો	Centuro
જન	Jan
બજારને	to the market
યે	Ye
ડોક્ટરનો	The doctor's
હરણ	deer
પ્રોપર્ટીકાર્ડ	PropertyCard
જાણીતા	Known
સોની	goldsmith
હર્ષને	Harsha
દર્શીલ	Darsheel
વેકેન્સી	Vacancy
મોહાબત્તે	Mohabbatein
સામસામે	face to face
સેલમાં	In cell
આસામમાં	In Assam
ઘરાકી	Gharaki
10200ની	Of 10200
ક્રુડ	crude
આપનારું	Giver
ગોવામાં	In Goa
ફટાકડા	Fireworks
ઓવર	Over
ટેન્શનમાં	in tension
કરોડ	crores
કપાઈ	cut off
જોનારાનાં	of the viewer
બહૂ	Bahu
ઇમોશનલ	Emotional
જ્વેલર્સનું	Of jewellers
સ્ટેન્ડર્ડ	Standard
ઓએનજીસી	ONGC
અમેરિકન	American
જીવંત	Alive
ચેટમાં	In Chat
ધડક	Banging
કર્મચારીઓની	employees
સ્કીમ્સ	Schemes
પરિમલ	Parimal
કઈ	Which
ગર્વનર	Governor
રાંધણગેસના	of cooking gas
સોનાની	of gold
પ્લાસ્ટિક	Plastic
ખેતીમાં	In agriculture
બતાવશે	Will show
ઇરફાન	Irfan
પટણીની	Patni
અંગૂઠાથી	With toe
છૂપા	Hidden
ગુમાવતા	Losing
શાહરૂખ	Shah Rukh
મગજમાં	in the brain
ટામેટાના	Tomatoes
પદ્મા	Padma
અવતારમાં	In avatar
વાર	Times
મફ્તમાં	Free of charge
નહીંતર	Otherwise
ધુમાડો	Smoke
એપમાં	In the app
બટાકા	Potatoes
સારાને	To Sara
લાઇફનાં	of life
મુક્તિ	Emancipation
લક્ષ્મીએ	Lakshmi
ફિચરથી	From feature
ખાતાધારકો	Account holders
વક્તવ્યની	of speech
ભાંગડા	Bhangra
વસ્ત્રો	Clothing
રચવાવાળી	The creator
પદે	In the post
અંકિતાને	To Ankita
અખ્તર	Akhtar
બદલાયેલા	Changed
હેડફોન	Headphones
સાકાર	True
બ્રાન્ચમાં	In the branch
કહેશો	say
સલમાનનો	Salman's
કુચડા	Kuchda
સુરવીન	Surveen
ટામેટાની	Tomatoes
રાખશો	Keep
680ની	Of 680
સંકળાયેલા	Involved
થવાના	to be
ઓછા	Less
રાખોઃ	Keep:
અંકિતાએ	Ankita
ટેક્સધારકોને	to tax holders
જીયો	Geo
સ્પર્ધક	Competitors
કાબિલ	Kabil
સગાઈમાં	In the engagement
છુપાયું	Hidden
તૈમુરે	Taimur
રણવિર	Ranveer
નસીબ	Luck
નિર્ણયથી	by decision
પેટ	belly
રીલ	Reel
ખાંડૂ	Khandu
આવનારી	Coming
શમશેરા	Shamshera
ફ્રન્ટ	Front
ભાઈજાને	Brother
ખાડામાંથી	from the pit
મહારાષ્ટ્રીયનોને	Maharashtrians
ઈનફિનિટી	Infinity
સમયમાં	In time
મહાશિવરાત્રિની	Mahashivaratri
ડી	D
હાસનની	Hassan's
વકીલોએ	Lawyers
સુખાનીએ	Sukhani
એપ્રુવ	Apruve
પોતાનાં	own
પેક્ડ	Packed
સ્ટૂડિયોની	Studios
ફરમાવતી	Fermavati
પોર્ન	Porn