एंडराॅयड	Android
के	Case-ending showing possession or relation
मामले	Case
में	In
यह	this
थोड़ा	little
पीछे	behind
है	have
।	।
एस्पेक्ट	Aspect
रेशो	Ratio
का	of
ईश्यू	Issue
और	and
हम	we
आशा	hope
करते	Do
हैं	Hey ! stop that !
कि	that
आने	Come
वाले	Those
अपडेट	Updates
फिक्स	Fix
कर	hand
दिया	given
जाएगा	Will
लेकिन	but
इस	this
तरह	kind
एक	one
मॉडल	model
घर	house
कंप्यूटर	Computer
लिए	for you
शानदार	splendid
विकल्प	option
हो	be
सकता	Can
गिर	fall
वन	forest
राष्ट्रीय	national
उद्यान	garden
बाघ	tiger
संरक्षित	protected
क्षेत्र	field
जो	who
एशियाई	Asian
बब्बर	Babbar
शेर	couplet
विश्व	universe
प्रसिद्ध	famous
हां	yes
,	,
फिल्म	film
हर	every
किरदार	character
भारद्वाज	Bhardwaj
को	for
भरद्वाज	skylark
क्यों	why
बुलाता	Call
?	?
फोन	Phone
उपयोग	utility
बेहद	boundless
ही	only
आसान	easy
टच	Touch
रिस्पॉरन्स	Response
उतना	that much
बेहतर	better
डिजिफलीप	Digiflip
प्रो	Pro
टेबलेट्	Tablets
अपने	Your
वर्ग	cla
सर्वोत्तम	best
युवाओं	Youth
कमजोर	weak
रैम	RAM
कारण	factor
बहुत	A lot
ज्यादा	more
उपयुक्त	appropriate
नहीं	No
मध्यमवर्गीय	Middle class
25	25
साल	Sal tree a timber tree
से	from
अधिक	more
आयु	lifetime
कामकाजी	working
लोग	people
गृहिणियां	Housewives
यां	
स्कूली	school
छात्र	pupil
चाहें	Want
तो	at that time
इसे	thi
पहले	at first
मोबाईल	Mobile
तौर	way
पर	given to
आजमा	Try
सकते	Can
पेरिस्कोप	Periscope
एंड्रॉयड	Android
वर्जन	taboo
कुछ	A few
ऎसे	Like that
यूनिक	Unique
फीचर्स	Features
भी	also
दिए	Given
गए	Gone
आईओएस	Ios
थे	were
वनों	Forests
की	possessive case-ending
विलक्षण	queer
वनस्पति	vegetation
तथा	and
हरे	O Lord
घास	gra
मैदानों	Plains
बीच	middle
यहां	here
नीलकुरंजी	Neelkuranji
नामक	named
फूल	flower
पाया	obtained
जाता	Are
टेबलेट	Tablet
कॉल	call
करने	To
क्षमता	competence
अच्छी	Good
इसकी	Its
आवाज़	voice
क्वालिटी	Quality
बढ़िया	excellent
इसमें	in it
5.5	5.5
इंच	inch
एचडी	Hd
डिस्पले	Display
स्क्रीन	screen
अल्ट्रा	Ultra
वाइड	wide
व्यूइंग	Viewing
एंगल	Angle
साथ	with
दी	Given
गई	Went past tense feminine singular of
जिससे	from whom
पिक्चर्स	Pictures
दिखती	Looks like
शोनाली	Shonali
मौजूदगी	presence
सोच	thought
समझदारी	understanding
स्तर	standard
जैसा	similar to
मैंने	I
कहा	said
था	was
प्रोसेसर	processor
गेम	game
खेलने	Play
विडियो	Video
पूरी	A thin bread or cake fried in ghee
सहज	innate
चलाने	Run
काबिल	Worth
असम	unequal
ब्रह्मपुत्र	Brahmaputra
नदी	river
किनारे	Edge
स्थित	situated
पार्क	park
गैंडे	Rhinos
-	-
हाथी	elephant
चीता	leopard
हिरण	deer
डॉल्फिन	Dolphin
सांभर	a species of antelope
आदि	beginning
देखे	Viewed
जा	Be off ! get away !
पोलेरिस	Polaris
आफिस	Office
एप	App
सहित	along-with
कई	many
अन्य	other
ऐसे	so
एप्लीकेशन्स	Applications
आपको	to you
रोजमर्रा	Everyday
कामकाज	business
मददगार	helper
साबित	full
होंगे	Will
ये	these
सभी	all
बातें	Things
'	'
एवेंजर्स	Avengers
:	:
एज	Edge
ऑफ	Of
अल्ट्रॉन	Ultron
देखने	View
मिलती	Get
माइक्रो	Micro
एसडी	Sd
कार्ड	card
अलावा	moreover
दो	the figure two
सिम	sim
डाले	Casts
इसका	thereof
13	13
मेगा	Mega
पिक्सल	pixel
कैमरा	Camera
डिवाईस	Device
हिरो	Hero
फ़्लैश	Flash
ना	not
होना	to be
बनता	Formed
इसके	It
अलावे	Addition
नोटिफिकेशंस	Notifications
आप	self
केवल	only
देख	seeing
उसका	his
जवाब	to a question answer
दे	give
थोड़े	a few
छोटे	Small
ज़रूर	Sure thing
इतने	So
इनसे	from them
कोई	so
परेशानी	distraction
चारमीनार	Charminar
आंध्र	Andhra
प्रदेश	region
राजधानी	capital
हैदराबाद	Hyderabad
सबसे	most
महत्वपूर्ण	important
स्मारक	memorial
कुल	family
मिलाकर	Together
टैबलेट	Tablet
मजबूत	strong
लगता	Feel
जबकि	whilst
डिसप्ले	Display
चारों	Around
ओर	side
उभरा	Emerged
हुआ	happened
प्लेटफार्म	platform
किसी	certain
सक्रैच	Scratch
रोकेगा	Stop
हद	limit
तक	until
उसकी	her
सुरक्षा	safeguard
करेगा	Will
सेल्फी	Selfie
वीडियो	Video
कॉलिंग	Calling
सकती	Can
जी3	G3
स्टाइलस	Stylus
परफॉर्मेंस	Utilities
अच्छा	good
अहम्	ego
बात	talk
डिज़ाइन	design
लुक्स	Looks
लेनोवो	Lenovo
जेड580	Z580
कहीं	somewhere
आगे	before
निश्चित	certain
रूप	figure
चुनाव	election
कमी	lack
स्किन	Skin
पसंद	likable
आ	The second vowel of the Devanagari syllabary
साधारण	ordinary
एंड्रायड	Android
4.1	4.1
जेली	jelly
बीन	Flute made of dried gourd used by snake charmer
ऑपरेटिंग	operating
सिस्टम	system
काम	work
करता	Does
कश्मीर	Kashmir
पर्यटन	tourism
बढ़ावा	encouragement
देने	Give
फेस्टिवल	Festival
बड़ा	A fried cake made of grounded pulse and spice
योगदान	contribution
देता	Give
मानसून	monsoon
मौसम	season
द	Added to impart the meaning of ‘giver’ as  giver of water
वैली	valley
फ्लावर	Flower
नेशनल	National
परिदृश्य	panorama
आश्चर्यजनक	wonderful
तरीके	Ways
सजीव	living
वाय	Y
फाय	Fi
तकनीक	technique
स्मार्टफोन	smartphone
अथवा	or
कनेक्ट	Connect
किया	Be
4.4	4.4
KitKat	KitKat
आता	coming
|	|
मतलब	purpose
केबल	Cable
माध्यम	medium
गाने	Songs
क्लिप्स	Clips
ट्रांसफर	Transfer
इलेक्ट्रोनिक	Electronic
कंट्रोल	control
पैनल	panel
मौजूद	present
एप्पल	apple
नए	new
15	15
लैपटॉप	Lap top
16	16
GB	GB
इंटरनल	Internal
मेमोरी	memory
2.2	2.2
GHz	GHz
क्वाड	Quad
कोर	point
इंटेल	Intel
गया	went
मोटा	fat
व	The twenty-ninth consonant of the Devanagari syllabary
भारी	heavy
होने	Be
बावजूद	In spite of
अच्छे	Good
डिजायन	Designed
वाला	keeper
10.1-इंच	10.1-inch
डिस्प्ले	display
रेजोल्यूशन	Resolution
1920	1920
x	x
1200	1200
पिक्सेल	Pixel
224	224
पीपीआई	Ppi
डेंसिटी	Density
इन	these
किट	kit
तहत	inferior
फिल्ममेकर	Filmmaker
एनिमेटर	Animator
हिसाब	reckoning
फोटो	Photo
मूवी	Movie
एडिटिंग	Editing
सकत	strength
इनवेन्ट	Invent
इट	It is
बिल्ड	Build
क्रिएट	Create
लिव	Liv
डिस्कवर	Discover
एक्सप्लोर	Explore
स्प्लैश	Splash
जैसे	as
अलग	detached
प्ले	play
एरियाज	Areas
लंबा	long
घुमावदार	winding
हस्ताक्षर	signature
वालों	People
अपना	one’s own
ड्रॉ	Draws
करना	to do
भरा	full
हिमाचल	the Himalaya
स्थलों	Destinations
दर्रे	Pass
लाहोल	Lahol
स्पीति	Spiti
जिलों	Districts
प्रवेश	entrance
द्वार	door
भावभूमि	Bhavbhoomi
उनके	Their
नई	new
अपरिचित	unacquainted
अपनी	Your
भव्य	splendid
सुंदरता	beauty
बड़ी	Dried tiny balls of grounded pulse
संख्या	number
पर्यटकों	Tourists
खींचता	Draws
गैलेक्सी	galaxy
नोट	currency note
800	800
लॉक	Lock
सिंपल	Simple
हैदर	Haider
खोज	search
नरेंद्र	king
झा	Jha
अन्दर	in
लगी	conflict
3120	3120
एमएएच	MAH
बैटरी	battery
पूरे	Whole
डेढ़	one and a half
दिन	Day period of 24 hour
चलती	Moving
बैद्यनाथ	Baidyanath
धाम	abode
बाबा	an old man
नामों	Names
जाना	to go
जाने	as if
झारखंड	forest of bushe
जिला	district
शहर	city
देवघर	Deoghar
पवित्र	pure
हिंदू	Hindu
तीर्थो	Pilgrims
प्लास्टिक	plastic
बना	compose
बैक	back
दिखने	Looking
काफी	quite
प्रीमियम	premium of insurance
याद	remembrance
दिलाता	Draws
सैमसंग	Samsung
Galaxy	Galaxy
Note	Note
4	4
कनेक्टिवीटि	Connectivity
3जी	3G
वाइ	Y
फाइ	Fi,
ब्लू	blue
टूथ	Tooth
इसी	this exactly
खूबी	Features
चलते	Go
फेबलेट	Phablet
लिया	took
यहा	Here
बाद	later
बिलकुल	You bet
मन	mind
जेम्स	James
वान	Van
सॉ	Saw
डायरेक्टर	Director
रहे	Stay
आपके	Your
आइफोन	iPhone
सीधे	straight
जाएगी	Will
आजादी	freedom
अरूणाचल	Arunachal
प्रशासनिक	administrative
केन्द्र	centre
स्थापना	Installing as of an idol
थी	Was
बेंचमार्क	Benchmark
स्कोर्स	Scores
आशाजनक	hopeful
क्योंकि	because
प्रतियोगिता	competition
दूर	distant
इंडोर	Indoor
डायमेंशन	Dimension
470	470
mm	mm
चौड़ाई	breadth
355	355
हाइट	Height
495	495
गहराई	depth
सिर्फ	alone
आकार	form
देखते	See
हुए	Happened
आसानी	ease
फॅब्लेट	Phablet
कहलाने	Called
पात्र	deserving
बैट्री	Battery
चार्ज	price
समय	time
लेती	Takes
अधिकांश	majority
यूआर्इ	UI
पूर्ववर्तियों	Predecessors
समान	common
चीज	thing
ठीक	Ok
करती	Doing
एन्वी	Envi
डीवी6	DV6
वज़न	weight
2.4	2.4
किलोग्राम	Kilogram
15-इंच	15-inch
बड़े	Large
वाली	keeper
मशीन	machine
सात	seven
जैली	Jelly
आपरेटिंग	Operating
1.9	1.9
1.6	1.6
गीगीहर्टज़	Gigihertz
माइक्रोसॉफ्ट	Microsoft
सरफेस	Surface
3	3
10.8	10.8
क्लियरटाइप	Cleartype
फुल	Full
HD	HD
प्लस	Plus
जरूर	fine
1जीबी	1GB
ग्राफिक्स	Graphics
कमियों	Shortcomings
ने	Ne
बेकार	unemployed
टेक्स्ट	Text
मैसेज	Message
क्विक	Quick
रिप्लाई	Reply
सपोर्ट	Support
जीबी	Gb
आतंरिक	Internal
स्टोरेज	storage
जेड1	Z1
कॉम्पैक्ट	Compact
तुलना	to be weighed
सुधार	reform
खास	separate
शॉट	shot
लेने	Take
टाइम	time
या	or
एप्प	App
खुलने	Opening
इन्हें	these
बैजू	Baiju
मंदिर	temple
नाम	name
अब	now
360कैम	360Cam
छोटा	little
सा	The first and basic note of the musical gamut
पावरफुल	Powerful
चुका	settle
पहली	First
नजर	sight
आपका	your
मोह	infatuation
अगर	if
गोवा	betel-nut
प्लान	plan
वहां	there
वाइब्रेंट	Vibrant
मजा	pleasure
ले	take
एलजी	Lg
हाइली	Hailey
कस्टमाइज्ड	Customized
यूआई	Ui
फैबलेट	Phablet
प्रयोग	use
चांदी	silver
दरवाजे	Doors
दरगाह	Tomb or shrine of a saint
निर्माण	building
चरणों	Steps
जहां	where
संत	saint
मूल	origin
कब्र	grave
संगमरमर	marble stone
बनी	Made
स्पीकर	speaker
बातों	Things
बोर	a dip
होते	
कारों	Cars
ड्रोन	Drones
मिसाइले	Missiles
दागी	Tainted
जाती	Caste
हालिया	recent
रिलीज	release
सैन	sign
एंड्रियास	Andreas
ऐसी	Such
कार्बन	carbon
Karbonn	Carbon
स्थापित	established
ब्रांड	brand
उन	Those
तमाम	whole
नये	New
प्रवेशकों	Entrants
जिनसे	from whom
प्रतिस्पर्धा	emulation
सेल	sale
एंड	End
सर्विस	service
नेटवर्क	network
जुड़ा	bun
Asus	Asus
Chromebox	Chromebox
कंप्यूटर�आप	Computer you
वायरलैस	wireless
क	The first consonant of the Devanagari syllabary
महज	Merely
क्लिक	Click
कॉन्फ्रेंस	Conference
समेत	Including
डॉक्यूमेंट्स	Documents
शेयर	share
दुःख	suffering
जिंजरब्रेड	gingerbread
पुराना	old
2.3.1	2.3.1
लगा	hook
वेलकम	Welcome
2	2
कराची	Karachi
नमूना	sample
मोटो	Moto
360	360
घड़ियों	Watches
दिखता	Looks
बांधवगढ़	Bandhavgarh
अभयारण्य	sanctuary
मध्य	mid
उद्यानों	Gardens
हमारे	Our
कीमत	value
विकल्पों	Options
जांच	investigate
खरीदने	Buy
बनाएं	Create
होगा	Will
बड़ा	A fried cake made of grounded pulse and spice
दिखनेवाला	Visible
चाहिए	is necessary
पॅनासोनिक	Panasonic
पी81के	P81K
बारे	finally
बार	Bar
कमिटमेंट	Commitment
फिर	again
मैं	I
सुनता	Listens
...	...
पर्दे	Curtains
सलमान	Salman
खान	mine
बोले	Snapped
पॉपुलर	Popular
संवाद	dialogue
तनु	body
वेड्स	Weds
मनु	proto-man
रिटर्न्स	Returns
तवेमरि	Tavemari
मनोज	One born in mind or emotion
शर्मा	Sharma
उर्फ	Aka
अंदाज	estimate
फेरबदल	alteration
बोलते	Speak
पप्पू	Pappu
टोकता	Tipping
तुम	you
क्या	What
चार्जिंग	Charging
टेस्ट	Test
चली	Lasted
बंटता	Divide
बड़ी	Dried tiny balls of grounded pulse
कमज़ोरी	weakne
बन	forest
मौकों	Occasions
पिता	Father
बेटी	Daughter
रिश्तों	Relationships
दर्शाने	Display
पिछले	Last
पांच	five
सालों	Years
दौरान	duration
विकास	evolution
मिला	connects
यदपि	Although
गेम्स	Games
इस्तेमाल	use
एंड्राइड	Android
उपकरणों	Devices
प्रभावित	influenced
जियाओमी	Xiaomi
एमआई	Mi
4आई	4i
एमआईयूआई	MIUI
6	6
5.0.2	5.0.2
चलता	going
व्यू	view
यूजर्स	Users
आंखों	Eyes
नुकसान	loss
पहुचाती	Arrive
नही	No
निराश	disappointed
टीवी	TV
जरिए	Via
स्ट्रीम	stream
किए	Are
कंटेंट	Content
होती	
कंपनी	Company
LED	LED
v580c	v580c
गर्म	hot
वास्तव	reality
शोर	noise
मुद्दों	Issues
पावर	power
रीटर्न	Return
लाने	Bring
प्रेस	press
होता	One who offers oblations in a sacrificial fire
उपलब्धि	attainment
विनीत	submissive
कुमार	prince
सिंह	lion
गिरीश	lord of the mountain
कुलकर्णी	Kulkarni
टचस्क्रीन	Touchscreen
रिस्पोंस	Response
आराम	rest
रहता	Lives
बोधगया	Bodh Gaya
सारी	All
संस्थाए	Institutions
करवाती	To do
स्‍मार्टवॉच	Smartwatch
वजन	weight
45	45
ग्राम	Gram
1	1
वजह	cause
परफार्मेंस	Performance
जिसमें	in whom
8	8
एमपी	MP
मैन	Man
ऑटोफोकस	Autofocus
सोनी	Sony
बीएसआई	BSI
सेंसर	censor
हमने	we
जल्दी	haste
पता	addre
लगाया	Imposed
समस्या	problem
उसके	her
दिये	Given
चार्जर	Charger
पीसी	Pc
हनिकॉम्ब	Honeycomb
3.2	3.2
डिवाइस	device
तैयार	ready
उन्हें	them
रिश्ते	Relationship
बहन	Sister
मालिनी	Malini
खुद	self
कहानी	story
कहनी	Tell me
स्पष्ट	explicit
लेखक	writer
निर्देशक	indicating
विधा	division
प्रस्तुति	production
प्रति	for each
ग्रिल	Grill
टॉप	Top
ब्लैक	Black
डिजाइन	design
एलीमेंट	Element
चलाना	to cause to move
आपकी	Your
जरूरत	need
उतनी	That much
स्पीड	Speed
केनन	Kenan
1200डी	1200D
18-55	18-55
लैंस	Lens
बदौलत	Thanks
तस्वीरें	Photos
खींचने	Pull
सक्षम	capable
1080पी	1080 p
प्लेबैक	playback
औसत	average
उम्मीद	hope
खरीद	buy
इससे	by this
न	The twentieth consonant of the losing anything Devanagari syllabary
करें	Do it
पहाड़ी	hill
खूबसूरत	Beautiful
दृश्य	sight
संबंध	relation
भेद	secret
विच्छेद	break
संवेद	Sensing
स्त्री	woman
पुरुष	man
कथित	said
आधुनिकता	modernity
आए	Came
असमंजस	suspense
लेकर	Ranging
हिंदी	Hindi
फिल्मों	Movies
घिसे	Ghise
पिटे	Pete
दृश्यों	Views
ऊपरी	upper
मजाक	sneer
उड़ाती	Flying
वैसे	By the way
रमती	Ramti
खेलना	to play
मोटोरोला	Motorola
बेस्ट	Best
लुक	glaze
आकर्षक	attractive
हुवैई	Huawei
मीडिया	media
पैड	pad of paper
सामान्य	general
शिकायत	grievance
बैकअप	Back up
कम	short
लाइफ	Life
टैब	tab
लगातार	continuously
लगभग	nearly
6.5	6.5
घंटे	hours
हाई	excessive craving
बैहर	Baihar
खेल	game
मैदान	a plain
अप्रैल	April
शुरू	beginning
दिवसीय	Day
बैगा	Baga
ओलिंपिक	olympic
आसपास	around
राज्यों	States
शामिल	including
वाकई	I mean it
स्लिम	Slim
सर्वाधिक	ahead of all
मोटाई	thickne
6.6	6.6
इंटरफेस	Interface
पुराने	Old
स्टाइल	style
हलांकि	However
750	750
थोड़ा	little
पतला	thin
माॅडल	Model
1.2	1.2
गीगाहर्ट्ज़	Gigahertz
मुंबई	Mumbai
प्राचीनतम	most ancient
स्थल	land
धरोहर	charge
शुमार	counting
राजकुमार	prince
हिरानी	Hirani
अभिजात	noble
जोशी	Joshi
संदेश	message
भगवान	god
मैनेजर	manager
बने	Made
स्वामी	master
गुरु	preceptor
मौलवी	A teacher of Islamic law or scholar of Islam
पादरी	Christian priest
डर	fear
आतंक	terror
फैला	spread
उल्लू	owl
सीधा	straight
छठे	Sixth
दशक	decade
सेना	to hatch egg
कैम्प	camp
विशेषताओं	Features
इंस्टालेशन	Installation
साफ़	clean
सुथरा	neat
यूजर	User
इंटरफ़ेस	interface
लाइफ़	life
अभी	just
हाल	condition
प्रेजेन्टेशन	Presentation
मेरा	my
उसी	same
ग्रस्त	swallowed
–	–
खराबी	malfunction
रेडिएंट	Radiant
मॉड्यूल	module
14.4mm	14.4mm
बेजल	Bezel
5000:1	5000:1
डायनामिक	Dynamic
कंट्रास्ट	Contrast
रेशियो	Ratio
एपल	Apple
वॉच	watch
सेट	a set of thing
इंतजार	wait
शशांक	Shashank
घोष	indistinct noise
हृषिकेष	Hrishikesh
मुखर्जी	Mukherjee
इरादे	Intentions
सोनम	Sonam
कपूर	camphor
देखेंगे	See
निराशा	disappointment
असंतुष्टि	dissatisfaction
होगी	hoagy
उंची	Height
घनता	thickness
आँखो	Eyes
सुखकारक	Pleasant
पढ़ने	Read
वीडीयो	Video
बिना	without
सेविंग	Saving
मोड	fold
एक्टिव	Active
चल	movable
बजट	budget
स्मार्टफोनो	Smartphones
नीचे	under
हिस्से	Part
आवाज़	voice
तेज़	sharp
ऐसा	like this
वाटरप्रूफ	Waterproof
बनाने	Create
वज़ह	Reason
साइज	size
यूएसबी	Usb
3.0	3.0
पोर्ट	port
मिनी	mini
एचडीएमआई	HDMI
प्रोडक्टिव	Productive
उम्दा	nice
प्रोडक्ट	Product
खामियां	Flaws
निराशाजनक	disappointing
आईफॉन	iPhone
महंगे	Expensive
वैरिएंट	Variant
सस्ता	cheap
ठहराता	Law
1280	1280
रेजोल्युशन	Resolution
32	32
विस्तारीत	In detail
मेमरी	Memory
करनेवाले	Who
स्लॉट	slot
द्वारा	by
जोड़ने	Add
पर्याय	synonym
ज्यादातर	Most
फंक्शंस	Functions
दमदार	virile
हालात	circumstance
परवरिश	bringing up
वर्तमान	modern
ऑटो	auto
फोकस	focus
वक्त	opportunity
गीतों	Songs
फिल्मांकन	Filming
पूरा	small village
ध्यान	attention
थ्री	Three
डी	D
हालांकि	although
लोकप्रिय	popular
एप्लीकेशनों	Applications
यूजरों	Users
मुद्दा	issue
ब्राइटनेस	Brightness
लेवल	level
आसुस	Asus
फोनपैड	Phonepad
10	10
परफॉरमेंस	Performance
बै	sale
फिल्में	Movies
पन्नों	Pages
बिगड़	Worsening
6,000	6,000
हुई	Happened
ज्‍यादा	More
बैकप	Backup
देती	Giving
स्टॉक	stock
ऍण्ड्रॉइड	Android
आम	Mango tree as well as fruit
दर्शक	seer
फाइंडिंग	Finding
फैनी	Fannie
अपेक्षित	required
आनंद	merriment
उठा	height
सकेंगे	Can be
जब	when
महसूस	felt
जेनफोन	Zenfone
5	5
सिम्पल	Simple
ऊबेंगे	Will get bored
बारी	time
कवर	cover
बदलकर	Altering
बदल	alternative
स्मार्टवॉच	Smartwatch
कूल	bank
गोल	round
डायल	dial
गूगल	Commiphora tree
लेटेस्ट	Latest
कंज्यूमर्स	Consumers
आकर्षित	attracted
रहा	Stay
41mAh	41mAh
करीब	nearly
30	30
द्वारका	having many gates
हिंदुओं	Hindus
चार	four
धामों	Dhams
सप्त	seven
पुरियों	Puris
गुजरात	Gujarat
द्वारिकापुरी	Dwarkapuri
मोक्ष	liberation
तीर्थ	Shrine or sacred place of pilgrimage
जानी	beloved
कलाकारों	Artists
राव	prince
गन्ना	sugar-cane
किसान	ploughman
सोनू	Sonu
सहरावत	Sehrawat
भूमिका	introduction
अभिभूत	overwhelmed
उपरी	Above
नयापन	newness
पीके	Pk
मिल	mill
जादू	magic
डॉल्‍बी	Dolby
एडवांस	Advance
ऑडियो	Audio
वी2	V2
साउंड	Sound
क्‍वलिटी	Quality
बढा	extend
नदियों	Rivers
पर्वत	mountain
पहाड़ियों	Hills
घिरा	encircled
अनोखा	strange
केरल	Kerala
हमेशा	always
सैलानियों	Tourists
हजारों	Thousands
लगे	toward
रोजाना	Daily
लाख	lac
लोगों	People
लंचबॉक्स	Lunchbox
सेवा	service
प्रदान	granting
10.1	10.1
एक्सडब्लूवीजीए	XWVGA
मल्टी	Multi
आईपीएस	Ips
जीरो	zero
एयर	air in combination
गेप	Gap
स्पेसिफिकेशन	Specification
बॉडी	Body
धब्बे	Spots
लगने	Seemingly
संभावना	possibility
छोटी	short
पिक्चर	Picture
चुने	Selected
डॉक्यूमेंट	Document
1007	1007
परिसंपत्तियों	Assets
वल्र्ड	World
हेरिटेज	Heritage
घोषित	declared
जिनमें	in whom
31	31
ट्रांसबाउंड्री	Transboundary
डिलिस्टेड	Deleted
46	46
इनडेंजर	Insider
779	779
कल्चरल	Cultural
197	197
नेचुरल	Natural
मिक्स्ड	Mixed
161	161
स्टेट्स	States
पार्टीज	Parties
आईएसओ	Iso
रेंज	range
लो	just see
लाइट	Light
कंडीशन	Condition
अच्‍छी	Good
फोटोग्राफी	photography
कैमरे	Camera
100	100
12,800	12,800
मैकबुक	MacBook
नया	New
आया	nurse
संस्करण	edition
जिसकी	Whose
13.1	13.1
एमएम	Mm
इसको	to this
बनाया	Created
बड़े	Large
आरामदाक	Comfortable
हाथ	hand
पकड़	grasp
बाघों	Tigers
रूबरू	Face to face
सही	right
जगह	place
समुद्रतल	Sea level
1300	1300
मीटर	Meter
ऊंचाई	height
काठमांडू	Kathmandu
मंदिरों	Temples
जिसका	whose
स्पीकर्स	Speakers
हाथों	Hands
ढक	Cover
जाते	Go away
इसलिए	therefore
संगम	confluence
यानी	that is
कह	Say
प्रदर्शन	exhibiting
औसतन	on an average
रखते	Keep it
एफएम	Fm
रेडियो	Radio
ब्लूटूथ	Bluetooth
कनेक्टीविटि	Connectivity
लैपटाप	Laptop
1/3	1/3
मेगापिक्सल	Megapixels
वेबकैम	Webcams
स्लाट	Slot
1.5	1.5
गीगाहर्त्ज	GHz
ऑक्टाकोर	Octacore
जिससें	By which
प्रोसेसिंग	Processing
परफोर्मेंश	Performance
सेरेब्रल	Cerebral
पालसी	Palsy
गतिविधियों	Activities
स्वाभाविक	natural
भंगिमाओं	Gestures
जज्ब	Soaking
उन्होंने	He
मानसिक	mental
क्षमताओं	Capabilities
सुंदर	Good looking
जाहिर	Course
भारत	India
टूरिस्ट	tourist
स्पॉट	Spot
बारह	the number twelve
महीने	Month
हलचल	agitation
रहती	Living
दौडऩे	Running
कोंकण	Konkan
रेलवे	railway
सफर	journey
एहसास	feeling
प्रोडक्टिविटी	Productivity
कमतर	smaller
देते	Give
अभिनय	dramatic action
यही	this very
कही	Where
वास्तविक	actual
मीडियापैड	Mediapad
लिंक	link
प्रतिद्वंदियों	Competitors
खामोशियां	Silences
लोकेशन	location
249	249
डॉलर	dollar
समझौते	Agreement
करेंगे	Will
उचित	proper
माइक्रोमैक्स	Micromax
बनाये	Made
यूरेका	Eureka
3220	3220
24	24
लगेंगे	Take
लैस	lace
एकबार	Once
ऑप्शन	Option
खोलने	Open
मुंह	mouth
बोलकर	By speaking
कमांड	command
फट	at once
वह	that
प्रकृति	nature
क्राईस्ट	Christ
चर्च	Church
मंकी	Monkey
पॉइंट	pt
कसौली	Kasauli
भट्टी	furnace
गोरखा	a man from Nepal
फोर्ट	Fort
किला	fort
एक्सपीरिया	Xperia
जेड	jade
रिफ्लेक्टिव	Reflective
आरामदेह	comfortable
हंसी	laughter
भाव	price
मुद्राओं	Currencies
संवादों	Dialogs
फूहड़	slovenly
होतीं	Are
बीकानेर	Bikaner
यात्रा	journey
राकेश	The lord of the moonlit night
लडेरा	Ladera
गाँव	village
मरुभूमि	Desert
महोत्सव	great festival
कार्यक्रम	programme
55	55
प्री	Prix
लोडेड	Loaded
एप्पलीकेशंस	Applications
कथ्य	Stories
संदर्भ	reference
भोपाल	Bhopal
ए	The eighth vowel of the Devanagari syllabary
प्रेयर	Prayer
फॉर	For
रेन	Rain
संगत	company
वस्तुनिष्ठ	objective
दृष्टिकोण	outlook
गैस	gas
ट्रैजेडी	Tragedy
चित्रण	act of painting
प्रासंगिक	relevant
जरूरी	imperative
पहाड़	mountain
सामने	in front
हिस्सा	share
जिधर	where
हमारा	our
होटल	Hotel
अंधकार	darkne
डूबा	drowned
डुअल	Dual
उच्च	high
डेफीनिशन	Definition
पिछला	back
एवं	and
1.3	1.3
चैटिंग	Chatting
खुबसूरत	Beautiful
2GHz	2GHz
एटम	atom
2580	2580
दवारा	By
संचालित	directed
दोनों	both
नीरस	juicele
अप्रभावी	null and void
डांसिंग	Dancing
डिस्ट्रैक्ट	District
स्टेटिक	Static
शिफ्ट	shift
एसुस	Asus
दूसरा	second
4जी	4G
तरफ	side
रू.	Rs.
8000	8000
हार्इ	
एण्ड	And
ऑरवाना2	Orvana2
माइक्रोस	Micros
70	70
एक्सबीए	XBA
एक्सट्रीम	Extreme
यूर्इ9000	UE9000
क्यूसी20आर्इ	QC20I
रखता	Keeps
25,000	25,000
बायीं	Left
मिनिमाइज	Minimize
निशान	mark
पाते	Find
नंबर	number
तीसरा	third
डायरेक्ट	Direct
टू-होम	To-Home
टेलिविजन	television
प्रोवाइडर	Provider
प्रयास	attempt
प्रभावशाली	influential
ढीलापन	loosene
ऊब	feeling of aversion
पैदा	born
चूकि	Because
पोर्ट्स	Ports
सब	sub-
मुश्किल	difficult
डयूल	Duel
एलईडी	Led
फ्लैश	Flash
88	88
डिग्री	degree from a university
जीपीएस	Gps
बढिय़ा	Good
व्यूविंग	Viewing
ऐंगल्स	Angles
बुरे	bad
वाईड	Wide
ऐंगल	Angle
थोडे	A little
रंग	colour
दिखते	Look
4K	4K
एंड्रॉइड	Android
बॉक्स	box
अमित	immeasurable
निर्देश	direction
जिम्मेदारी	binding
बखूबी	Brilliantly
निभाते	Play
एक्स100	X100
लुभावना	charming
खासकर	preferably
नीरज	Anything born out of water
पांडे	Pandey
विधान	arranging
प्रेडिक्टेबल	Predictable
टेक्नोलॉजी	Technology
ऋषि	sage
चड्ढा	Climbing
किरदारों	Characters
रची	Hatched
अंदाजा	estimate
ला	Law
आयुर्वेदिक	Ayurvedic
कितना	How much
महत्व	importance
यथार्थ	accurate
सफल	successful
कोशिश	effort
सीमित	limited
कनेक्टिविटी	connectivity
वाई	Y
फाई	Fi
ब्‍लूटूथ	Bluetooth
USB	USB
सुविधा	convenience
लद्दाख	Ladakh
जून	June
अक्टूबर	October
महीना	month
पूर्वोत्तर	north-east
राज्य	kingdom
प्राकृतिक	natural
बदलते	Change
विश्वभर	Around
पहचान	recognition
वे	they
जमीन	earth
एस	ace
पेन	Pen
होल्डर	holder
बाहर	outside
निकालते	Remove
दाहिनी	right
कोने	Corner
मीनू	Menu
खुल	open
तथ्य	fact
खिलाफ	reversal
अप्रचलित	obsolete
2.3	2.3
आधारित	based on
ब्लूटुथ	Bluetooth
दक्षिण	south
एशिया	Asia
ट्यूलिप	tulip
गार्डन	garden
सप्ताह	week
आयोजन	arrangement
मस्जिद	mosque
भारतीय	Indian
मुस्लिम	Muslim
वास्तुशैली	Architectural style
उदाहरण	example
विक्रम	prowess
राठौड़	Rathore
पाकिस्तानी	Of or belonging to Pakistan
अभिनेता	actor
फवाद	Fawad
प्रतिभा	intellect
मुग्ध	infatuated
ज़ेडटीइ	ZTE
वी5	V5
बनावट	make
निकाली	Removed
कार्टून	cartoon
राक्षसों	Monsters
कितनी	How
लड़ाइयां	Battles
लड़ी	string as of pearl
जाएंगी	Will
सीमा	border
मेगापिक्‍सल	Megapixels
सीन	scene
डिटेक्‍शन	Detection
फेस	Face
रिकॉग्‍नाइजेशन	Recognition
इनहेंसमेंट	Enhancement
पैनोरमा	Panorama
जियो	Live
टैगिंग	Tagging
बस्‍ट	Bust
स्‍माइल	Smile
एचडीआर	HDR
ऑप्‍शन	Option
पर्यटक	tourist
भर	fill
जाइरो	Gyro
यदि	if
मनमोहक	adorable
देखना	To see
नवम्बर	November
रहेगा	Will
किलोमीटर	Kilometer
नमक	salt
उत्पादन	production
हाउसिंग	Housing
स्टेनलेस	Stainless
स्टील	steel
निर्मित	constructed
स्टेटिस्टिक्स	Statistics
स्टेंडबाई	Standby
प्रोसेस	Process
कॉन्सम्पशन	Consumption
प्रतिशत	per cent
दिखाता	Show
आदर्श	ideal
20	20
फीसदी	Per cent
कॉन्टैक्ट	Contact
लिस्ट	list
इमेज	Image
प्रोफाइल	Profile
हाइलाइट	Highlight
थम्बनेल	Thumbnail
11	11
प्रेसेट	Preset
मोड्स	Modes
इफेक्ट्स	Effects
आठ	eight
फ्रेम	frame
चुन्गथांग	Chungthang
हसीन	beautiful
वादियों	Litigants
चाय	tea
चुस्कियों	Kisses
थकान	fatigue
रही	Rahi
ली	took
दूसरे	secondly
बीबीएम	BBM
ग्रुप	group
चैट	chat
ऑवरऑल	Overall
पैकेज	package
फीचर	Feature
गलतियां	Mistakes
होंगी	Will
अकाउंट	Account
हैक	hack
पहाड़ों	Mountains
खासियत	Usp
यहाँ	here
देर	long time
लगती	Seem
परिणाम	result
तीन	the number three
मीठे	Sweet
पानी	water
झरने	Waterfalls
नेहा	Neha
धूपिया	Dhupia
संघर्षरत	engaged in struggles
अभिनेत्री	actress
मसाले	spices
फॉर्मूले	Formula
मशहूर	well-known
अल्ट्राबुक	Ultrabook
512GB	512GB
SSD	SSD
हार्ड	Hard
डिस्क	disk
रोशनी	light
बिल्कुल	absolutely
शार्प	Sharp
बारीकीयों	Nuances
भरपूर	brimful
आते	Come
जिसके	Which
इतनी	So
फिसलेगा	Will slip
झरनों	Waterfalls
बसे	Settled
हिल	rock
स्टेशन	station
मनोरम	lovely
मोहित	fascinated
देगा	Will
Gear	Gear
S	S
सुविधाजनक	convenient
उन्नीसवीं	Nineteenth
सदी	century
बोली	dialect
माहौल	surroundings
रचने	Masterminding
टीम	team
मेहनत	labour
सराहनीय	laudable
विशेष	special
अनुभूति	feeling
समाप्त	The end
ब्रुश्ड	Bruised
फिनिश	Finnish
सुन्दर	beautiful
उत्तराखंड	Uttarakhand
गोद	lap
धनौल्टी	Dhanaulti
गढ़वाल	Garhwal
मसूरी	Mussoorie
तीस	the number thirty
थॉर	Thor
कैप्टन	Captain
मूव्स	Moves
दिखाई	showing
देंगे	Will
इनमें	These
अंतर	difference
जसीडीह	Jasidih
जंक्शन	junction
प्रमुख	foremost
भागों	Parts
जुड़ा	bun
अंडरवर्ल्ड	Underworld
एनकाउंटर	Encounter
सुर्खियों	Headlines
शब्द	word
मेरी	My
12	12
वारंटी	warranty
खत्म	Finish
मरता	dying
वायरलेस	Wireless
अतिरिक्त	extra
रुपए	Rs.
खर्च	expenditure
फिल्टर	Filter
प्रोटेक्शन	Protection
ताकि	So that
कमरे	Room
सांस	breath
मगर	crocodile
क्‍वॉड	Quad
माउंटेन	Mountain
अलटीमेट	Ultimate
वॉचबैंड	Watchband
आईपॉड	iPod
नैनो	Nano
कवरिंग	Covering
निमार्ण	Creation
महान	great
मल्टीमीडिया	multimedia
श्रृंखला	chain
आईफ़ोन	iPhone
ए6	A6
शक्तिशाली	potentate
एप्स	Apps
बैकग्राउंड	Background
धीमा	tardy
लंबे	Long
चलने	Run
2430	2430
केनवस	Canvas
टेब	Tab
पी480	P480
क्वॉडकोर	Quadcore
आउटडोर	Outdoor
एक्स्ट्रा	Extras
प्रकार	kind
फैबलेत	In the phablet
यूज	Use
क्लियर	Clear
खूबियों	Merits
श्याओमी	Xiaomi
जुलती	Similar
डीएसएलआर	DSLR
मुकाबले	Than
इनकार	denial
3.15	3.15
मेगापिक्सेल	Megapixels
720पी	720p
रिकार्डिंग	Recording
शिवानंद	Shivanand
आश्रम	hermitage
बड़	banyan tree
पेड़	tree
आज	today
फाइंडर	Finder
कवरेज	Coverage
बोर्ड	board an administrative body
कोर्इ	None
स्पोर्ट्स	Sports
चैनल	Channel
फ्लैगशिप	Flagship
नेक्सस	Nexus
स्मूथ	Smooth
खूब	Plenty
जबरदस्त	tremendously
ड्रामा	drama
देश	country
हिस्सों	Parts
रोगी	patient
श्रद्धालु	devoted
ग्राफ़िक्स	Graphics
आइडियापैड	IdeaPad
जेड500	Z500
सकें	Can
ड्राइव	drive
गेमिंग	Gaming
कंट्रोलर्स	Controllers
सपोर्टेड	Supported
डिवाइसों	Devices
वनलाइनर	Oneliner
मजेदार	funny
बढ़कर	ahead of
विशेषताएं	Features
ईमानदारी	honesty
जाए	Go
जी	Yes
सच	truth
“नो	"No.
नॉनसेंस”	Nonsense."
जूलियस	Julius
बडी	Buddy
भावना	feeling
नोटीफिकेशन	Notification
जिसे	That
बढ़ाया	Enhanced
उपयोगी	useful
एप्पलीकेशन	Application
खुले	Open
आसमान	sky
धोबीघाट	washerman’s workplace
कपड़े	clothes
थोते	Thote
अविस्मरणीय	unforgettable
झलक	gleam
फ्रंट	Front
फेसिंग	Facing
फिंगरप्रिंट	Fingerprint
मैगनेट	Magnets
गीगाहर्टज	Gigahertz
कोरटेक्स	Cortex
ए9	A9
श्रेणी	cla
संतोषजनक	satisfying
टक्कर	collision
हैंडसेट्स	Handsets
बढि़या	Good
आयरिस	Iris
फ्यूल	Fuel
60	60
नेविगेशन	Navigation
छुट्टियों	Holidays
योजना	plan
अच्‍छे	Good
निकॉन	Nikon
पिक्‍सल	Pixels
पॉकेट	pocket
फ्रेंडली	Friendly
फ्रेंडशिप	Friendship
लव	tiny particle
64	64
अपग्रेड	upgrade
उंचाइयां	Heights
छूने	Touch
जरुर	Must
जिम	gym
कॉर्बेट	Corbett
कुमाऊ	Kumaon
अद्भूत	Stupendous
घिरे	Surrounded
जंगल	jungle
रामगंगा	Ramganga
बसा	Settle
कैपचरिंग	Capturing
प्रोलॉग	Prolog
एप्लीकेशन	Application
फायदेमंद	beneficial
जिन्हें	That
मोबाइल	Mobile
फाइलों	Files
डाउनलोड	download
पड़ता	cost price
चूंकि	since
मुफ्त	free
उपलब्ध	obtained
जायें	Go
किन्ही	None
मायनों	Ways
हमें	To us
रिलायंस	Reliance
रह	way
हैंडसेट	Handset
स्‍विच	Switch
डाटा	data
उड़	Fly
उपदेश	sermon
भार	obligation
दबे	Buried
मुकाबला	Combat
नीला	dark blue
तब	then
बाकी	except
स्पाइस	Spice
स्टेलर	Stellar
होराइजोन	Horizon
Spice	Spice
Stellar	Stellar
Horizon	Horizon
स्पेसिफिकेशन्स	Specifications
800x480	800x480
रिजॉल्यूशन	resolution
रियर	Rear
1Ghz	1Ghz
मीडियाटैक	MediaTek
Mediatek	Mediatek
चिपसेट	Chipset
512	512
MB	MB
RAM	RAM
2400	2400
mAh	mAh
मजबूती	firmness
बढ़	heighten
3डी	3d
किनेट	Kinet
तेज	warmth
जप	Adoration by repeating phrases or formulas from scriptures
लगाना	To attach as an enclosure
भूलते	Forget
नोकिया	Nokia
808	808
प्योरव्यू	PureView
Nokia	Nokia
PureView	PureView
प्रधान	head
एन	en
N8	N8
सच्चा	true
उत्तराधिकारी	heir
लंबी	A long stride of a horse
छलांग	leap
विवोबुक	VivoBook
एफ202ई	F202E
आई3	I3
वज़ह	Reason
तेज़	sharp
पूर्वाभासी	foreboding
भविष्य	future
जारी	continued
रखना	to keep
चाहते	Want
कॉन्टेस्ट	Contest
पॉल्स	Pauls
लेते	Take
पॉइंट्स	Points
मिलते	See
मज़ेदार	tasteful
उपकरण	apparatu
बनाते	Create
मनीष	Manish
गुप्ता	A married woman who withdraws from her husband’s endearment
रहस्य	secret
हत्या	murder
गुत्थियों	Gutthias
सुलझाती	Solving
बेहतरीन	best
यूई	UE
उत्पादों	Products
खूबियां	Features
डेटा	data
बल्कि	rather
पहला	first
नोटबुक	notebook
5वें	5th
जेनरेशन	generation
आइ7	i7
याहू	yahoo
मैसेंजर	Messenger
वट्स	Watts
एैप	App
Adreno	Adreno
305	305
GPU	GPU
लाईफ	Life
पॉवर	Power
वॉल्यूम	volume
वहीं	at that very place
फुजीफिल्म	Fujifilm
90	90
सीरीज	series
एचपी	Hp
लैपटॉप्स	Laptops
करे​क्टिंग	Correcting
आर्इओएस	ios
कीबोर्ड	Keyboard
लावा	lava from a volcano
II	II
डाइग्नली	Clinically
7	7
नाप	measurement
केपेसिटिव	Capacitive
पाइंट	point
800X480	800X480
4.0	4.0
आइस	ice
क्रीम	Cream
सैंडविच	Sandwich
Android	Android
Ice	Ice
Cream	Cream
Sandwich	Sandwich
18	18
आइलैंड्स	Islands
मिलकर	Consisting
फैरो	Ferro
द्वीप	island
समूह	group
स्वर्ग	paradise
भीड़भाड़	overcrowding
रहना	to reside
प्रेम	love
गंगा	The river Ganga or Gange
यमुना	Yamuna
सरस्वती	Goddess of speech and learning
मिलन	association
स्थान	place of origin
कार	Car
बस	Bus
पिक्‍चर	Picture
जुड़े	Associated
पृथक	separate
विशेषता	speciality
क्वैड	Quaid
4G	4G
कार्य	work
किटकैट	KitKat
रन	runs in cricket
8,888	8,888
रुपये	Bucks
हज़ार	one thousand
रूपयों	Rupee
खरीदें	Buy
वोल्टाज	Voltage
विंडो	window
जरिये	Via
इन‍कमिंग	In Coming
रिप्‍लाई	Reply
डॉन्गल्स	Dongles
एडॉप्टर	Adapter
फाइल	file
ब्राइटनेसपर	Brightness
वाइफाइ	Wifi
अनेबल्ड	Enabled
घंटा	bell
चलाई	Run
%	%
उतरी	Landed
वीयर	Weir
ज़ेड	zed
धातु	metal
चेसिस	Chassis
हली	Hali
लिहाज	Terms
/	/
गीत	song
सिक्वेंस	Sequence
दर्शकों	Audience
बहल	Behl
अधूरी	unfulfilled
मानी	meaning
बासुकीनाथ	Basukinath
दर्शन	seeing
वायुमार्ग	The track of the wind
पटना	to be filled
निकटतम	closest
हवाईअड्डा	Airport
स्थानों	Places
उड़ानों	Flights
लेपटॉप	Laptop
एकसाथ	Together
इच्छा	desire
रखने	Keep
मौका	chance
LG	LG
G3	G3
हफ्ते	Week
लॉलीपॉप	lollipop
डिवाइसेज	Devices
करण	instrument
ठहराव	settlement
बुनियादी	basic
Micromax	Micromax
फनबुक	Funbook
Funbook	Funbook
अपग्रेडेट	Upgrade
मार्ग	way
शाहबलूत	chestnut
बुरूंश	Burunsh
लाल	ruby
पीले	Yellow
सेबों	Apples
ब़ागों	Bugs
किन्नौर	Kinnaur
कैलाश	Kailash
चोटी	Tuft of hair on the top of the head
छवि	splendour
देखा	seen
जीएचजेड	GHz
क्वालकॉम	Qualcomm
स्नैपड्रगन	Snapdragon
400	400
प्रोसेर	Prosser
कान्हा	Kanha
भ्रमण	going round
संस्कृृति	Culture
उनकी	Their
परम्पराओं	Traditions
अवसर	opportunity
मिलेगा	Get
लाहौर	Lahore
गेट	gate
मुख्य	main
प्रवेशद्वार	gateway
गहरे	Deep
344	344
हल्का	light
डे	De
शुरुआत	beginning
1982	1982
इकोमास	Ecosmas
इंटरनेशनल	international
काउंसिल	council
ऑन	On
मोन्यूमेंट्स	Monuments
ऐंड	And
साइट्स	Sites
संस्था	institution
50वीं	50th
1965-2015	1965-2015
एनिवर्सरी	Anniversary
सेलिब्रेटकर	Celebrate
ट्यूनीशिया	Tunisia
साइट	site
रीयर	Rear
परफार्मेश	Performance
एटॉम	Atom
2जीबी	2 gb
ग्लास	glass
अगली	next
बाजू	side
ढंकता	Cover
धब्बो	Spots
उंगलियों	Fingers
निशानों	Traces
नॉर्वे	Norway
समीप	near to
भले	Well ! all right !
दुनियाभर	Worldwide
अंजान	Unknown
जगहों	Places
शौकीन	devotee
पहुंच	Access
कॉर्निग	Corning
गोरिल्ला	gorilla
ग्लास3	Glass3
मठ	abode of an ascetic
अनोखी	extraordinary
वास्तुकला	Art or technique of house building
शैली	style
खींचती	Pulls
कैमरों	Cameras
ए7एस	A7S
4के	4K
सुधारों	Reforms
आवश्यकता	necessity
सड़क	road
मात्र	merely
लगेगा	Take
उनका	their
व्यस्क	Adult
हॉलीवुड	Hollywood
इंग्लिश	English
क्रेज	Craze
हेल्थ	Health
रिजॉर्ट	Resort
हिंदु	Hindu
तीर्थस्थान	pilgrimage
देवगढ़	Deogarh
सचेत	vigilant
रहने	Stay
खरीदारों	Buyers
प्रतीत	appeared
साइनोजन	Cyanogen
ओएस	Os
अपीयरेंस	Appearance
कस्टमाइजेशन	Customization
कहना	to say
खाना	food
होकर	By
प्रेशर	pressure
कूकर	dog
स्थिति	condition
पड़	Fall
रिजोल्यूशन	Resolution
800X600	800X600
कैनवस	canva
टर्बो	turbo
आउटपुट	output
कहते	Say
वॉशिंग	Washing
कपड़े	clothes
धोने	Wash
लग	touch
देखें	See
बाजार	market
इंट्री	Entry
के-500	K-500
क्लाइमेक्स	Climax
अजय	unconquerable
शुक्ला	Shukla
अनुपम	matchless
खेर	Kher
नोंक	Knock
झोंक	tension
तनाव	tension
ढीला	loose
राहत	repose
म्यूजियम	Museum
सातों	all the seven
खुला	open
खिलता	Blooms
बनती	Created
500	500
2.30	2.30
पेंटियम	Pentium
बनाता	Builds
हमारी	Our
सलाह	advice
निर्णय	decision
730	730
अवश्य	without fail
रखें	Keep
अनोखे	Unique
जेडटीई	ZTE
आई	coming
एक्शन	action
कमाल	perfection
यूनिवर्सल	Universal
रिमोट	remote
सुरक्षित	safe
वीडीयोज़	Videos
चलाएं	Run
उसमें	in it
हल्के	Lightweight
रिड्रॉ	Ridro
ग्रेन	grain
उससे	therefrom
अनुभव	experience
फर्क	disagreement
पड़ा	laid aside
यूफिट	Ufit
बैंड	band
स्टेप	step
ट्रेकिंग	Trekking
स्लिप	slip
डिस्टेंस	Distance
वॉक	walk
कैलोरी	unit of heat
बर्न	Burn
आर्थिक	economic
फिल्मी	Film
हस्तियों	Celebrities
उद्योगों	Industries
विख्यात	generally known
टैग	tag
यद्यपि	although
अभ्यस्त	practised
आतंकवादी	terrorist
पहुंचने	Arriving
व्यूह	maze
रचना	construction
घटनाक्रम	sequence of event
पर्याप्त	adequate
उत्सुकता	eagerness
बनाए	Created
रखी	Laid
डीवी6-7206टीएक्स	DV6-7206TX
डब्बेवालों	Dabbawalas
हुजूम	crowd
चर्चगेट	Churchgate
फिजीकल	Physical
दाईं	Right
1024	1024
600	600
7-इंच	7-inch
पीएलएस	PLS
एलसीडी	Lcd
डेफिनेशन	Definition
ज़रूर	Sure thing
आईपैड	iPad
वही	The same
रॉ	Raw
RAW	.RAW
जेपीइजी	JPEG
JPEG	.JPEG
लाभकारी	remunerative
दायीं	Right
वर्टिकल	Vertical
मेन्यू	menu
एनी	Annie
कैचअप	Catchup
ट्रेंडिंग	Trending
प्रोग्राम्स	Programs
फ्री	Free
वीडियोज	Videos
प्रीव्यू	Preview
वैल्यू	Value
एडेड	Added
16GB	16GB
शक्ति	power
स्नान	bath
हजार	thousand
रु	face
सी	c
मिलता	Get
अधिकतर	more than
फाइबर	fiber
ब्रेडेड	Breaded
स्टॉपर	Stopper
लेफ्ट	left
राइट	wright
पतली	Thin
गये	Gone
झाड़ीनुमा	Bushy
पौधे	plants
41	41
इमेजिंग	imaging
इंजिनियर्स	Engineers
ऑप्टिक्स	Optics
फेसटाइम	FaceTime
रिकॉर्डिंग	recording
जिस	oblique form of  who
व्यक्ति	person
ब्लैकबेरी	Blackberry
समझने	Understand
फ्लोटिंग	Floating
.1-इंच	.1-inch
मज़बूत	strong
जेब	pocket
समा	Time
नोटिफिकेशन	Notification
डिटेक्‍ट	Detect
लेगी	Will
मैसेजेस	Messages
इंफार्मेशन	Information
देगी	Will
नायक	Hero of a play or story
उस	that
विभिन्न	open
चरित्रों	Characters
गढऩे	To build
कभी	ever
बंद	joint
लूमिया	Lumia
540	540
दाम	price
खूबसूरती	Beauty
अद्भुत	fantastic
परिचय	introduction
कमियां	Drawbacks
जिन	oblique pl. of
देना	To give
सिम्बियन	Symbian
^	^
Symbian	Symbian
बेले	Belle
Belle	Belle
OS	OS
फ़ोन	phone
ऑप्टिकल	Optical
स्टेबिलाइजेशन	Stabilization
ऑप्शन्स	Options
LTE	LTE
3G	3G
3200mAh	3200mAh
घोषणा	declaration
बताया	Told
वैज्ञानिक	scientist
D5300	D5300
स्‍क्रीन	Screen
एफ	F
मोटर	motor
आवाज	sound
पॉंइन्ट	Point
खामिया	Flaws
स्मार्ट	smart
मैट	mat
गुजरता	Passes
बता	show
मेहराब	arch
शाम	Evening
8एक्स	8X
जूम	Zoom
2.7	2.7
230	230
प्रसंता	Happiness
लिनोवो	Lenovo
3000	3000
1024x600	1024x600
मार्क	mark
07	07
स्कोर	score
3420	3420
3426	3426
भाग्य	fate
ओपनजीएल	OpenGL
ईएस	ES
0.3	0.3
यूमथांग	Yumthang
सुन्दरता	beauty
जितने	as many
चर्चे	Discussion
सुन	hear
रखे	Placed
पड़ा	laid aside
स्लो	sloe
लाया	Brought
भाषा	language
लहजे	Accent
मराठीपन	Marathiness
डालने	Insert
हेक्टर	Hector
किस्मों	Varieties
बिरंगे	Colorful
लुभाता	Tempting
रॉय	Roy
रणबीर	Ranbir
खोए	Losing
स्नैमपड्रैगन	Snapdragon
410	410
गीगाहर्ट्ज	GHz
क्वाडकोर	Quadcore
प्रासेसर	Processor
रेडमी	Redmi
1एस	1S
स्नैपड्रैगन	snapdragon
स्मार्टफ़ोन	smartphone
64-बिट	64-bit
1.8GHz	1.8GHz
4GB	4GB
64GB	64GB
128GB	128GB
एक्सपैंड	Expand
पटकथा	screenplay
169	169
तीनों	Three
ज़रूरतों	Needs
रख	place
बीचो	In the middle
बायें	to the left
पावॅर	Power
होम	sacrifice
वापस	returned
बटन	button
सपाट	flat
किनारों	Edges
सेंट्रल	Central
रिसर्च	Research
इंस्टीट्यूट	institute
लॉरेंस	Lawrence
स्कूल	School
क्वालिटि	Quality
बटनों	Buttons
चेहरा	face
भावों	Emotions
अनुरूप	similar
बदलता	changing
गीतांजलि	Gitanjali
वीजीए	Vga
रेजल्यूशन	Resolution
सेकेंडरी	Secondary
टोन	tone
एलइडी	LED
सब्जेक्ट	Subject
लाइटनिंग	Lightning
करके	By
क्‍योंकि	Because
कैनन	Canon
एसएक्‍स	SX
150IS	150IS
कॉम्‍पैक्‍ट	Compact
आकर	Come
असीम	boundless
संतुष्टि	satisfaction
स्वाइप	Swipe
अल्टीमेट	Ultimate
प्रभावोत्पादक	effective
उत्पाद	product
माना	Believe
श्री	Lakshmi
च्योतिर्लिग	Chyotirlig
अवस्थित	situated
उसे	her
इंटेक्स	Intex
5000	5000
उत्तम	best
इंची	Inches
आयताकार	rectangular
धन्यवाद	Thank you
पकड़ने	Catch
वाल्यूम	Volume
रॉकर	Rocker
बगल	armpit
पोंर्ट्रेट	Portrait
परा	denoting away
HDMI	HDMI
न्होंने	Not
संयम	control
शिष्टता	politeness
एलिफेंट	Elephant
सफारी	Safari
हाथियों	Elephants
साइन	sine
लैंग्वेज	Language
सीख	advice
जाएंगे	Will
ख्वाजा	Khwaja
मोइनुद्दीन	Moinuddin
चिश्ती	Chishti
दूरी	distance
सेंसिटिव	Sensitive
टास्क	Task
मेनेजर	Manager
स्वागतयोग्य	Welcome
मुहावरों	Idioms
सटीक	annotated
323	323
फ्लोरा	Flora
फना	Fana
प्रजातियों	Species
दिखाने	Show
चक्कर	wheel
फिसल	slip
सिल्वर	Silver
ग्रे	grey
mAH	MH
एमबी	Mb
इंटरन	Intern
माइक्रोएसडी	MicroSD
लगाकर	Planting
वाईफ़ाई	Wifi
जीपीआरएफ	GPRF
जीपीएफ	GPF
योगा	Yoga
निश्चय	certainty
हिन्दू	Hindu
साहित्य	literature
मुताबिक	accordingly
चिदंबरम	Chidambaram
शिव	the good
प्रकृतिक	Natural
तत्वों	Elements
प्रतिनिधित्व	representation
मेटेरियल	Material
इन्स्पायर्ड	Inspired
मॉडर्न	Modern
ब्लूम	Bloom
ग्लोब	globe
म्यूजिक	Music
परंतु	but
हमे	We
लाउडस्पीकर	loudspeaker
प्लेसमेंट	Placement
आत्मविश्वास	self-confidence
भरे	Filled
डायरेक्शन	Direction
दिल	heart
छूती	Touching
कोर्टरुम	Courtroom
स्टेंडर्ड	Standard
स्‍टाइल	Style
टेक	prop
यूज़ेबिलिटी	Usability
G	G
Watch	Watch
R	R
अन्‍य	Other
राजा	reign
विवादास्पद	contentious
रखा	Placed
समाज	society
द्वंद्व	duel
शीर्षक	caption
थीम	theme
जायकेदार	Delicious
धर्म	duty
संकट	crisis
ब्रिटिश	british
कॉमेडी	comedy
इनफिडेल	Infidel
प्रेरित	inspired
ड्यूल	Dual
ARM	ARM
कोर्टेक्स	Cortex
A9	A9
जीपीयू	Gpu
1GB	1GB
DDR	DDR
एक्सपेरिया	Xperia
सोला	A pithy stemmed Indian plant
रोमांचकारी	thrilling
विजेट्स	Widgets
साफ	clean
सोने	Gold
जितना	as much a
तापमान	temperature
वो	That
धर्मां	Religions
कठमुल्लापन	Stubbornness
निशाना	target
साधने	Tools
स्टेज	stage
पास	near
डिज़ाइन	design
किये	Done
275,000	275,000
छोड़	abandon
रेलमार्ग	railway
प्लांट	plant
229	229
मैमल	Maimal
बर्ड	Bird
एम्फिबियन	Amphibian
43	43
रेप्टाइल	Reptile
प्रजातियां	Species
पाई	pie
प्लेयर	player
खोलते	Open
मिलेंगे	Meet
पटनीटॉप	Patnitop
जम्मू	J
उधमपुर	Udhampur
जिले	District
सर्वश्रेष्ठ	best of all
खराब	bad
सॉफ्ट	Soft
डिटेल्स	Details
दिनों	Days
एसफाल्‍ट	Asphalt
8:	8:
एयरबॉर्न	Airborne
डिवाइसेस	Devices
पेश	present
मरीज	patient
बोझ	burden
मानता	recognition
जोड़ा	pair
पारदर्शक	transparent
एल	el
एचआरडी	HRD
यूतुब	YouTube
लोड	Load
लेता	Takes
सुखविंदर	Sukhwinder
नायब	deputy
संगीत	music
मौजूदा	current
कालखंड	Period
मिजाज	base
नाकाम	unsuccessful
क्रोएशिया	Croatia
स्कूबा	Scuba
डाइविंग	Diving
सेलिंग	Sailing
वॉटर	Water
गेलक्सी	Galaxy
नॉट	Not
4और	4 and
आईफोन	iPhone
हरा	green
धर्मपाल	Dharampal
निभाया	Fulfilled
स्नेक	Snake
बोट	boat
रेस	race
लाई	parched rice
लंबाई	length
120	120
फीट	Feet
नावक	a small arrow
चलाते	Run
कोणों	Angles
आईबॉल	iBall
चुना	Chosen
बाईं	left
ऊपर	up
सेलेक्ट	Select
अंतिम	final
सहयात्री	co-traveller
उतने	all
जंचते	Check
ब्योमकेश	Byomkesh
स्टैंड	stand
विविध	various
रूपों	Forms
सकने	Can
लगाने	Putting
बेफिक्र	Unconcerned
घूम	turning
इमरान	Imran
हाशमी	Hashmi
बेअसर	Neutralize
जासूसी	detective
गति	movement
धीमी	faint
ओक्टा	Okta
615	615
बिट	bit
ऑक्टा	Octa
जानने	Learn
दुनिया	world
चाहेंगे	Would
वी4.0	v4.0
ग्लोनैस	GLONASS
चमक	glitter
प्रतिबिंब	reflection
चमकदार	glittering
बढ़ाया	Enhanced
तरीका	posture
300	300
डेन्सिटी	Density
प्रोफेशनल	Professional
डॉक्यूमेंट्री	Documentary
शूटिंग	shooting
इवेंट्स	Events
कल्पना	imagination
वीएफएक्स	VFX
बुरा	bad
चबूतरे	Pops
मुरंड	Murand
तालाब	tank
सौंदर्य	beauty
ऐतिहासिकता	historical genuinene
किताबों	Books
लिखा	written
योग्य	able
खरा	genuine
उतरता	descending
जीमेल	Gmail
ऑफलाइन	Offline
माडल	Model
माइक्रोएसबी	MicroSB
खरीदना	buy
पड़ेगा	Have
1000	1000
कीज	Keys
keys	Keys
इनोवेटिव	Innovative
कलर	Color
मिडनाइट	Midnight
मेटल	Metal
कहूँगा	Say
ब्रश्ड	Brushed
ज़बरदस्त	strong
स्मिता	Smita
जयकर	Cheer
स्वानंद	Swanand
किरकिरे	Gritty
मराठी	Marathi
न्याय	justice
चारूदत्त	Charudutt
आचार्य	Founder of some sect or of philosophical school of learning
मुद्दे	Issue
स्थानीय	local
बढ़ती	increase
प्रतिद्वंद्विता	rivalry
25000	25000
लैपटापों	Laptops
भरमार	abundance
एप्‍लीकेशन	Application
मिलेंगी	Will meet
फेसबुक	Facebook
ओपेरा	opera
हंगामा	uproar
एड्रिएटिक	Adriatic
समुद्र	sea
मढ़ी	hut
पसंदीदा	favourite
व्यंजनों	Recipes
मनाली	Manali
रुख	posture
बढ़ाकर	Enhanced
बाई	lady
सिंगल	single
विवान्ट	Viwant
जीसी	GC
340	340
लान्च	Launch
क्रोमबुक	Chromebooks
लेपटॉप्स	Laptops
डेस्कटॉप	desktop
विशेषतौर	Especially
बिजनेसमेन्स	Businessmen's
टैब्लेट	Tablet
माक्रोफोन	Microphone
ओपनिंग	Opening
वॉयस	Voice
क्रिस्टल	crystal
मिलेगी	Will
सुबह	morning
खबर	news
आओ	Come
नज़ारा	sight
स्मूद	Smooth
वेन	Wayne
हॉरर	Horror
जोनर	Joner
फार्म	Form
पहुंचाता	Transmits
AC	AC
53	53
LBS999	LBS999
संबंधी	relative
ब़	B
$	$
ढावा	Run
चयन	selection
व्यवसाय	profession
बालाघाट	Balaghat
टूरिज्म	Tourism
प्रमोशन	Promotion
गठन	constitution of the body
2000mAh	2000mAh
12-13	12-13
कहे	Saying
खामी	Drawback
भषाओं	Languages
सस्ती	cheap
कैटेगरी	Category
निर्माता	builder
अपेक्षा	expectation
मैजू	Maiju
एम2	M2
2जी	2G
चौड़े	Wide
तस्वीरों	Photos
मोशन	Motion
वीडियोग्राफी	Videography
लैप्स	Lapses
इंटरवल	interval
एक्सपोजर	Exposure
एफपीएस	Fps
व्हाइट	white
बैलेंस	Balance
सेटिंग	Setting
क्लाउडी	Cloudy
इनकैनडिसेंट	Incandescent
डेलाइट	Daylight
प्लूरोसेंट	Fluorescent
क्यूवीजीए	QVGA
स्नैपशॉट	Snapshot
प्रिया	darling
सूर्यवंशी	Kṣhatriya community belonging to or descending from solar dynasty
तापसी	female ascetic or hermit
पन्नू	Pannu
वसीम	Wasim
सुशांत	Sushant
भिड़ंत	encounter
उल्लेखनीय	mentionable
पहाड़ों	Mountains
सैर	walk
वेस्टर्न	western
घाट	wharf
पहाड़	mountain
प्रचलित	prevalent
मनोरंजक	interesting
उपादानों	Subsidies
सहारा	support
क्लास	class
एप्लिकेशन	App
बिजनेस	busine
हुवेई	Huawei
24,999	24,999
रूपये	Rs.
510	510
बाज़ार	market
हैदराबादी	Hyderabadi
अत्यधिक	very much
मल्टीटास्किंग	Multitasking
हरियाली	greenery
छा	
सूखे	Dried
तलाब	Pond
मिले	Are
दम	suppression
हईशा	Haisha
धीरे	slowly
उतरती	Landing
सिनेमा	Cinema
हॉल	Hall
निकलने	Get out
बसी	Sit down
सलीके	Salike
बांध	tie
पाती	leaf especially dried leaf
आती	Come
पायोनियर	Pioneer
परेश	the Almighty
रावल	Title of certain Rajput chieftain
अन्नू	Annu
लोहा	iron
नज़र	sight
लगाये	Put it
भट्ट	Bhatt
निर्देशित	directed
मिस्टर	mister
एक्स	X
सड़कों	Streets
बीचोंबीच	in the very middle
भीग	Drenched
जाये	Go
चिंता	anxiety
ज़रूरत	need
35	35
रूपए	Rs.
पश्चिम	West
बंगाल	Bengal
राच्य	Rachya
दक्षिणी	southern
भाग	luck
सुंदरवन	Sundarbans
डेल्टा	delta
ब्लुटूथ	Bluetooth
एमआइ	MI
पेयर	Pair
ज़रूरी	necessary
कनेक्टर	connector
घड़ी	watch
महंगी	Expensive
ख़राब	bad
परिपूर्णता	brimful
सौम्य	amiable
शांत	cool
वातावरण	atmosphere
प्लेट	Plate
नॉब्स	Nobbs
क्लासिक	classic
वीयू	VU
5.8	5.8
जोकि	Which
620	620
एसर	Acer
आईकोनिया	Iconia
स्लेटबुक	Slatebook
एक्स2	X2
टेगरा	Tegra
ख़ुशी	joy
उम्मीदों	Expectations
यंगिस्तान	Youngistan
जैकी	Jackie
भगनानी	Bhagnani
उम्मीए	Hope
जगाई	Wake up
सघन	dense
अस्फाल्ट	asphalt
DH3	DH3
टेंपल	Temple
खेले	Played
फ्रीज	Freeze
लैग	Lag
आना	an old
आइडिया	Idea
Z510	Z510
अधिग्रहण	acquisition
बोल्ड	Bold
9900	9900
मुक़ाबले	Competition
ज़्यादा	more
स्पेस	space
50	50
लाइफ़	life
बताना	to tell
ऊंची	High
बजनेवाले	Ringing
जीएलबेंचमार्क	GLMundice
ग्राफ़िक्स	Graphics
गवाह	witne
डुएल	Dual
कॉस्ट	Cost
टैबलेट्स	Tablets
लाभ	profit
स्‍टोरेज	Storage
पक्षियों	Birds
गुलजार	Buzzing
अल्पाइन	Alpine
फूलों	Flowers
आबादी	inhabited place
ट्रेवल	Travel
डेस्टिनेशन	Destination
बताने	Tell
जाकर	Go
प्राप्त	received
XT701	XT701
कोटि	grade
रूचि	interest
मूल्य	value
रंगों	Colors
शब्दों	Words
प्रतिद्वंदी	Opponent
टेबलेट्स	Tablets
शरीर	mischievou
फिसलन	slipperine
हल्क	Hulk
आयरनमैन	Ironman
टसल	Tussal
ई	The fourth vowel of the Devanagari syllabary
Moto	Moto
E	E
2nd	2nd
Gen	Gen
कर्व	Curve
आरामदायक	comfortable
सोर्स	Source
इनपुट	input
क्रोम	chrome
पट्टी	bandage
डिजाईन	Design
बेजोड़	unmatched
लिंडलोफ	Lindlof
नॉक	Knock
कोड	code
अनलॉक	Unlock
विशिष्टता	special characteristic
हार्डवेयर	The machinery and electronic parts of a computer
परवर्तन	Reflection
परिवर्तन	change
बदलाव	change
तारतम्यता	Consistency
अनेक	more than one
टूटती	Stretching
4.5	4.5
खुशनूमा	Happy
ऍस्फाल्ट	Asphalt
फीफा	fifa
14	14
गडबड़ी	Disturbances
चले	Away
अाप	You
यकीनन	Arguably
जीवन	life
उनलोगों	Those people
जिनकी	Whose
उपेक्षा	neglect
रहते	Live
अपरंपरागत	unorthodox
लगाए	Planted
नापसंद	disliked
प्राथमिकताओं	Priorities
निर्भर	dependent
गयी	On
सेगमेंट	Segment
अनेकों	Many
सूर्य	the sun
प्रकाश	light
फैक्टर	Factor
विचार	thought
40,000	40,000
परव्यय	Expenditure
9	9
अन्नदाता	bread-giver
चट्टान	rock
खिसकाने	Move
देरी	delay
बेड़ा	fleet
गर्क	Gark
!	!
इकोनॉमिकल	Economic
विंडोज	Windows
येलो	Yellow
ग्रीन	Green
पिंग	reddish brown
कलर्स	Colors
च्वॉयस	Choice
उतारा	crossing of a river
जलवायु	climate
अनुसार	according
बदलती	Changing
3-4	3-4
रिचार्ज	Recharge
पैडोमीटर	Pedometer
केंद्रों	Centers
विश्वविख्यात	world-famous
परफॉर्मंस	Performance
लेना	to take
16जीबी	16GB
13,999	13,999
रहें	Stay
इंस्टॉल	Install
Xiaomi	Xiaomi
मंगलवार	Tuesday
Online	Online
Flash	Flash
Sale	Cell
मार्केटिंग	Marketing
स्ट्रैटजी	Strategy
नकारा	Denied
घटिया	inferior
कतई	Certainly
सोलंग	Solang
अंजनी	stye
महादेव	An epithet of god Shiva
धार्मिक	religiou
दोहराव	Act of doubling or folding
शायद	May be
जैसी	Like
सादगी	simplicity
निभा	conducts
पाता	Finds
हटाना	to remove
असिस्टेंट	assistant
एडी	ankle
निर्वहन	Discharge
सड़कमार्ग	Road
फूलबानी	Phulbani
नगरों	Cities
एक्सटरनल	External
नूतन	new
जज	Judge
सदावर्ते	Always
मिडिल	Middle
दिखाया	Shown
बूते	Own
चर्चा	discussion
20,000	20,000
सबब	factor
अत	therefore
एयरटेल	Airtel
करे	Do it
डील	physique
असाधारण	uncommon
बकाया	outstanding
सुखद	pleasant
दांई	Right
हैे	Hey
आख्ंा	Akhon
मूवमेंट	Movement
फाॅलो	Follow
दांयी	Right
आंख	eye
पुतलियों	Pupils
निशुल्क	Free
भटक	stray
अर्थात	i.e
खीचंी	Khich's
तस्वीर	picture
ठाक	Good
एचटीसी	HTC
खींच	pull
कोशिशों	Attempts
व्यर्थ	useless
हल्की	light
संख्याओं	Numbers
नतीजा	result
निकाल	eject
चलेगा	Will
उपभोगताओं	Users
देग	large metal pot
कार्यक्षमता	capacity to work
घड़ी	watch
बर्तनों	Pottery
जर्मन	German
फिसलर	Fisler
फ्रैंकफर्ट	Frankfurt
आयोजित	planned
व्यापार	trade
मेले	Fair
प्रदर्शित	show
सूरज	The sun
पढ़	Read
तेवर	eyebrow
देसी	native
बैलेंस्ड	Balanced
आर्मेचर	armature
ड्राइवर	Driver
रेगुलर	Regular
डायनेमिक	Dynamic
इंडिकेटर	Indicator
सवाल	question
पीछा	hind part
छोड़ेगा	Will leave
बनाई	Created
user	User
interface	Interface
आईसीएस	Ics
ICS	.ICS
UI	UI
चौबीसी	Chaubis
ऐतिहासिक	historical
चबूतरा	platform
देशभर	Country
चर्चित	discussed
एस10.5	S10.5
.2	.2
स्‍टेंडअलोन	Standalone
म्‍यूजिक	Music
प्‍लेयर	Player
जिंक	zinc
900	900
909	909
999	999
लगते	Takes
स्वरूप	appearance
पक्ष	side
सामाजिक	Having to do with society
सांस्कृतिक	cultural
विरासत	heritage
रखती	Holds
अप	bad
डालें	Insert
320mAH	320mAH
खींचे	Drag
नॉइज़	Noise
मिली	Found
क्वॉलिटी	Quality
पूर्व	east
सैकड़ों	hundreds
घंटी	tiny bell
लटका	a simple remedy
रमण्ीय	Pleasant
ब्राइटनैस	Brightness
760	760
8-इंच	8-inch
भुज	arm
पहुंचते	Arrive
हस्तशिल्प	handicraft
यूथ	group
आएंगे	Will come
पसीने	Sweat
तर	wet
सावधानी	caution
बरतने	Exercise
उनमें	in them
हैः	It is:
जस्टिन	Justin
लिन	Lynn
आश्चर्यचकित	astonished
ऐप्स	Apps
उत्तर	north
हंसेंगे	Will laugh
शब्दक	Wording
मुहावरे	Phrases
जिंदगी	life
पैसा	The money
प्रवासी	migratory
सुनना	to hear
पक्षी	bird
विहार	monastery
इंटरनेट	Internet
लाइव	live
वेबसाइट्स	Websites
नेटफ्लिक्स	Netflix
HBO	HBO
शो	show
चिप	Small piece cut or broken off from wood
रास्पबेरी	Raspberry
पीआई2	PI2
चाइनीज	Chinese
बैकपैनल	Backpanel
मार्टिन	Martin
नोटिफायर	Notifier
चला	lightning
एक्टिविटीज	Activities
दीपिका	small lamp
पादुकोण	Padukone
नृत्य	dance
सारे	All
फीके	Fade
BBM	BBM
version	Version
Voice	Voice
उपभोक्ता	consumer
वाईफाई	Wifi
WiFi	WiFi
तार्र्किकता	Rationality
जेड990	Z990
बीटेल	Beatle
एचसीएल	Hcl
आईबेरी	Eyeberry
वाइल्ड	Wild
शौक	hobby
राजस्थान	Rajasthan
माउंट	mount
आबू	Abu
वन्यजीव	Wildlife
सेंचुरी	Century
जाएं	Go
10-इंच	10-inch
दिवंगत	deceased
पॉल	Paul
वॉकर	Walker
गुड	Good
बाय	Bye
होस्ट	Host
सोचते	Think
छह	six
साइड	side
परिक्षण	Test
साड़ेपाच	Five and a half
घंटो	Hour
फ्लॉलेस	Flawless
गोलाकार	global
कराते	Do it
थ्रिल	Thrill
मात्रा	quantity
रोमांच	horripilation
आब्जेक्ट	Object
मैप	map
नाच	dance
ईडीजीई	EDGE
जीपीआरएस	GPRS
ओटीजी	OTG
ऑप्शंस	Options
शक	doubt
स्लीक	Sleek
स्टाइलिश	Stylish
डूअल	Dual
स्कीम	scheme
क्लॉस	Claus
फ़्लैश	Flash
खेलते	Play
तेजी	drift
एकदम	all at once
चमकीला	brilliant
ढंग	mode
करेंट	current of electricity
पुनः	again
स्क्रिप्ट	script
सीमाओं	Limitations
रोचक	interesting
इंडस्ट्री	industry
बेपरवाह	heedless
रवैए	Attitude
इंगित	hint
राजगीर	mason
चट्टानी	rocky
प्रासंगिकता	relevance
कलात्मकता	Artistry
सिनेमाई	Cinematic
कौशल	skill
वास्तविकता	reality
10,000	10,000
6,27,500	6,27,500
Apple	Apple
iPhone	iPhone
5c	5c
5s	5s
Plus	Plus
8.2	8.2
रौशनी	light
एंगल्स	Angles
प्रतिद्वंदियो	Competitors
130	130
उनसे	from them
पाकिस्तान	Pakistan
दिलचस्प	interesting
अनूठा	uncommon
कॉंसेप्ट	Concept
काल	time
शासकों	Rulers
बच्चों	children
लेडीज	Ladies
एलटीई	LTE
बैड	Bed
बॉय	Boy
सीरियल	serial
किसर	Kiser
निखिल	entire
प्रोटेक्टिव	Protective
मैग्नेट	Magnets
पैराग्लाइडिंग	Paragliding
मई	May
सितंबर	September
गाड़ियों	Trains
खिड़कियों	Windows
क्षण	instant
प्रतिक्षण	Every moment
गुजरते	Passing
धान	paddy
खेत	field
हिमाच्छिदत	Snow
चोटियाँ	Peaks
सुहाना	pleasant
हैसियत	rank
हरी	green
भरी	Full
शांन्त	Calm
टैली	Tally
घाटी	mountain pa
पुरानी	chronic
मेघना	Meghna
गुफा	cave
2600	2600
तुरंत	immediately
पहुंचा	Scaled
दायरे	Realm
श्रीनगर	Srinagar
कश्मीरी	of Kashmir
पश्मीना	Pashmina
शॉल	shawl
स्टोल	stole
लकड़ी	wood
शिल्प	craft
ऐप	App
मूवीज़	Movies
ट्रेलर्स	Trailers
रिव्यु	Review
ऑफिस	office
प्रेडिक्शन्स	Predictions
जान	knowledge or information
डेटाबेस	database
IMDb	IMDb
आपने	You
लम्बे	Taller
सिरिअल	Serial
वाम्मी	Left
1080	1080
पी	The cry of a cuckoo reminding lovers of each other
पूर्ण	full
स्ट्रीमिंग	streaming
मेगाहर्ट्ज	Mhz
समर्पित	dedicated
उन्नत	lofty
इटरेक्टिव	Interactive
सिया	Sia
अमायरा	Amyra
दस्तूर	practice
ट्रिम	Trim
बढ़ा	exacerbate
होमी	Homi
मूड	mood
चित्रित	painted
क्वा	Kw
लिटी	Fitness
गीगाहर्ट्ज़	Gigahertz
अटैंड	Attend
इनबिल्ड	Inbuilt
माइक्रोफोन	microphone
सती	A faithful and chaste woman
52	52
शक्तिपीठों	Shaktipeeths
उठते	Getting up
अलॉर्म	Alarm
वाइब्रेट	Vibrate
नकारात्मक	negative
उपन्यास	novel
छू	Blowing or breathing sound made by a washerman beating clothes on a slab
वज़न	weight
1.44	1.44
पौंड	pound
पीना	to drink
मँहगा	Expensive
पड़ता	cost price
परिसर	neighbourhood
आप्शनस	Options
मसलन	for example
80	80
कथानक	plot of a story
चीजें	Things
भूल	forgetfulness
क्रोमबुक्स	Chromebooks
चिकलेट	Chicklet
आदिवासी	aborigine
अपा	You
टनी	Tany
स्थाई	ever
निवासी	resident
प्रेमियों	Lovers
पैनेल	Panel
सीक्वल	Sequel
चुनौती	challenge
तालमेल	harmony
बैठाने	Sit down
वेणुवन	Venuvan
बांसों	Bamboo
वेणु	bamboo
बिम्बसार	Bimbsar
बुद्ध	awakened
बनवाया	Built
त्रिवेणी	Three locks of hair plaited together
कहलाता	Called
ऎसी	Such
डिकोड	Decode
सर्क	Sark
अभिव्यक्ति	expression
व्यवधान	interruption
मॉडल्स	Models
आकर्षण	attraction
प्रदर्शनी	exhibition
डिजिटल	digital
टूडी	Tody
एस60	S60
गिग	Gig
क्‍वॉलकॉम	Qualcomm
स्‍नैपड्रैगन	Snapdragon
माली	gardener
450	450
फील	Feel
चुभते	Pinch
नीलगिरि	Nilgiris
नीले	Blue
पर्वतों	Mountains
ऊटी	Ooty
स्टेशनों	Stations
कहानीकार	story-writer
राहिल	Rahil
काजी	working
रवींद्र	Ravindra
गौतम	Gautama
मकसद	Motive
भिन्न	different
आयाम	dimension
अटकने	Stuck
यूज़र्स	Users
दिक्कत	trouble
320	320
AMOLED	AMOLED
प्राइस	Price
ऐक्वा	Aqua
i7	i7
स्पेसिफिकेशंस	Specifications
स्टॉरेज	Storage
कपैसिटी	Capacity
ब्राउजिंग	Browsing
सिरीज	Series
मूवीज	Movies
नोशन	Notion
इंक	ink
केन	Ken
देकर	By
दूसरी	Second
कम्पनियों	Companies
कड़ी	hard
खुश	happy
बैंगनी	Of the colour of brinjal
अफसोस	regret
दिबाकर	Dibakar
भोजपुरी	The dialect of Bhojpur in Bihar spoken in and around Ballia and Chhapra district
वैसा	like that
सिग्नेचर	Signature
क्लिप्श	Clipsh
एस4आर्इ	S4I
वेब	web
ब्राउज़िंग	Browsing
सोशल	Social
नेटवर्किंग	networking
970	970
प्रजाति	race
174	174
39	39
स्तनधारी	a mammal
180	180
औषधीय	pharmaceutical
पाए	Found
ब्रोकन	Broken
हॉसेस	Hodges
विधु	the moon
विनोद	diversion
चोपड़ा	Chopra
अटैंप्ट	Attempt
दुर्भाग्यवश	unfortunately
फेल	Fail
एवरेज	Average
एंजॉय	Enjoy
दिखाती	Shows
गुफाएं	Caves
झरनें	Waterfalls
हुवावे	Huawei
स्‍कीन	Skin
एडिट	Edit
संभव	possible
1280x720	1280x720
पिक्सल्स	Pixels
रेजॉलूशन	Resolution
4.3	4.3
बाजर	Market
पाएं	Get
2.0	2.0
शूट	Shoot
तकनीकी	technical
कुशलता	competence
निर्वाह	carrying out
नवीनता	newness
एक्टिंग	Acting
फेर	turn
थोड़ी	small
कन्‍फ्यूजिंग	Confusing
रोहतांग	Rohtang
बर्फ	snow
जमा	collection
लदे	Laden
नाला	brook
गुलाबा	Rose
राहलाफाल	Relief
मनोरंजन	entertainment
लॉन्च	launch
बताएगा	Tell
कला	art
यथास्थिति	as the situation warrants
हिमायती	supporter
दरअसल	actually
प्‍लस	Plus
प्‍ले	Play
बुक	book
स्‍टोर	Store
सर्च	An act of looking for information in a computer database
यू	u
ट्यूब	tube
हैंगआउट	Hangouts
गईं	Gone
27,900	27,900
नवाजुद्दीन	Nawazuddin
सिद्दीकी	Siddiqui
फितरत	Fit
फराह	Farah
शाह	king
पिछली	last
हूं	I am
ओम	ohm
शांति	peace
हैप्पी	Happy
न्यू	gnu
ईयर	Year
सैलानी	wanderer
मोड़	bend
मरोड़	twist
तकलीफदेह	Painful
सेंड	Send
प्रक्रिया	proce
दिल्ली	Delhi
मुगलकालीन	Mughal period
नायाब	not easily available
अक्सर	often
अपग्रेडेड	Upgraded
फास्टर	Faster
रेट्राकेबल	Retractable
ओएलईडी	OLED
ट्रू	True
फाइंडरटीएम	FinderTM
जेडईआईएसएस	ZEISS
टी	Tea
ब्रॉडकास्टर	Broadcaster
अपलोड	upload
रिप्पले	Ripple
सेव	Save
सेन्टर	center
एजुकेशन	Education
कंजर्वेशन	Conservation
वॉकवे	Walkway
2900	2900
फ़ोन	phone
ढंके	Cover
इतना	as much
सिहर	simmering
सहम	Saham
म्युजिक	Music
फिटनेस	Fitness
इनफोकस	InFocus
एम330	M330
मैमोरी	Memory
पहने	Wearing
प्रशंसनीय	praiseworthy
आइपी67	IP67
सर्टिफाइड	Certified
धूल	dust
फिलहाल	current
चौकोर	quadrangular
फायदा	profit
अतीत	past
कथाएं	Stories
इतिहास	history
संरक्षण	protection
शोध	research
साक्ष्यों	Proofs
आधार	base
लिखी	Written
समुचित	quite proper
मेकअप	Make up
कॉस्ट्यूम	Costume
निखरता	Brightness
सॉल्युशन	Solution
कंबाइंड	Combined
अया	Aya
सीजन	Season
जुटते	Gather together
920	920
Lumia	Lumia
स्नेपड्रैगन	Snapdragon
एस4	S4
एमएसएम8960	MSM8960
एड्रीनो	Adriano
225	225
7.9	7.9
आईपेड	iPad
एल्युमीनियम	aluminium
गुणवत्ता	quality
जैक	jack
निचले	Lower
उपस्थित	present
कूकू	Kooku
दावे	Claim
3,997	3,997
हार्ट	Heart
रेट	rate
स्‍लीप	Sleep
साइकल	Cycle
एक्‍सरसाइज	Exercise
रूटीन	Routine
फॉलो	Follow
अग्ली	Ugly
कुरूपता	malformation
लें	Take
नजरिया	Viewpoint
आधुनिक	Up to date
मदद	help
स्वास्थ्य	health
लगाती	Putting in
निराशानजक	Disappointing
अविश्वसनीय	unworthy of belief
डिंपल	Dimple
भूमिकाओं	Roles
150	150
मैंग्रोव	Mangroves
टिकट	Ticket
वॉलेड	Walled
भुगतान	payment
प्रणाली	system
ऑनलाइन	Online
सफेद	White
कम्बिनेशन	Combination
ट्रेडमार्क	trademark
एमपी4	MP4
फाइल्स	Files
देशों	Countries
मेल	connection
मिलाप	union
हास्यास्पद	ridiculous
प्रसंगों	Contexts
पैसे	money
डालकर	Enter
बारात	marriage party
7.8	7.8
पतले	Thin
डेल	Dell
परफोर्मेश	Performance
टेक्सट	Text
गोल्‍डेन	Golden
डॉट्स	Dots
प्‍वॉइंट्स	Points
रिप्रेसेंट	Representative
नतीजतन	consequently
विषय	subject
खेतों	Farms
6x	6x
डिजीटल	Digital
बाबत	account
चेक	Czech
रिजल्ट्स	Results
पॉजिटिव	Positive
बास	scent
पोक्र्यूपिन	Pokrupin
हेट	Hate
सॉन्ग्स	Songs
मैसिव	Massive
अटैक	Attack
एंजल	Angel
ट्रैक्स	Tracks
समझा	I see
LCD	LCD
चलाया	Run
फ्रिज	Fridge
इर्गोनोमीकली	Ergonomically
बैठता	Sits
लिये	For
आकर्षणों	Attractions
दीवान	Minister of a princely state
ए-आम	A-Aam
ए-ख़ास	A-Khas
हमाम	Turkish bath
शाही	royal
बुर्ज	tower
मोती	pearl
रंगमहल	An apartment for festive enjoyment
एएमडी	AMD
रेडिओन	Radio
एचडी7670एम	HD7670M
लाज़वाब	Amazing
ड्रीम	Dream
6500	6500
विशालकाय	monolithic
पुरे	Enough
माचु	Machu
पिच्चु	Picchu
आइलैंड	Island
साउथ	South
अमेरिका	America
पेरु	Peru
जानदार	living
कैंप	camp
एक्सपेरिमेंट	Experiment
चूक	default
निम्न	low
सस्ते	Cheap
वहीँ	Right there
ET701	ET701
खामियों	Flaws
कामयाब	successful
GPS	GPS
जानकर	knowingly
A	A
SIM	SIM
एंटर	Enter
ईजी	Easy
5एस	5S
उपभोक्ताओं	Consumers
जेड2420	Z2420
हाइपर	Hyper
थ्रेडिंग	Threading
एप्पस	Apps
+	+
ऑइकन	Icon
हटाकर	Deleting
काले	Black
बदला	retaliation
सबका	Everyone's
पड़े	Lying down
एप्पलीकेशन्स	Applications
सिन्धु	Sindhu
सभ्यता	civilization
स्वतंत्रता	independence
सेनानियों	Fighters
तराशे	Crooked
हिरों	Diamonds
वोस्ट्रो	Vostro
1366	1366
गुणा	multiplication
768	768
रेज्योलूशन	Resolution
15.6	15.6
बिल्ट	Built
बुरी	bad
ईयरपीस	Earpiece
प्राइवेसी	Privacy
डफ़ोन्स	Duffons
4000	4000
लय	rhythm
अमेरिकी	American
200	200
12,688	12,688
बूट	boot
कौसर	Kausar
मुनीर	Munir
अर्थ	meaning
सहजता	ingenuity
स्वाभाविकता	naturalne
खो	dispel
एल्यूमिनीयम	Aluminium
सुविधानुसार	at one’s convenience
अंधेरे	Dark
178	178
आएगी	Will
डिवाईसो	Device
रखकर	Placing
उभर	Emerging
दिखे	Do
सौ	hundred
सोमवार	Monday
निम	neem tree
सभागार	assembly hall
बैठक	seat
शीतकालीन	of winter
पहलुओं	Aspects
ग्रिड	grid
बैटमैन	batman
अरखम	Arkham
ऑरिजन्स	Originals
स्ट्रीट	street
फाइटर	Fighter
टेक्कन	Tekcan
चलाउ	Let's run
नियमित	regular
ज़रूरत	need
पड़ेगी	Will fall
26	26
जैन	A sect who follow the teachings of Jain Tirthankara
ऑपशन्स	Options
चुननी	Select
लाइन	line
फोन्स	Headphone
गरम	hot
कथा	story
बढऩे	Growing
छिटकती	Splashing
आखिरकार	After all
बिखर	Shattered
आपपास	Near you
देशी	indigenous
विदेशी	foreign
4.04	4.04
आइसक्रीम	Ice cream
साफ्टवेयर	Software
बढ़िया	excellent
निकला	Derives
इमेजेस	Images
थीं	Were
बनीं	Made
लाइब्रेरी	Library
ऑर्किड	orchid
विविधता	variety
जेसे	Like
कामों	Deeds
यूजफुल	Useful
कॉन्टेक्ट	Contact
कॉन्टेक्ट्स	Contacts
कोडेक्स	Codex
मार्केट	market
मोबो	Mobo
सौहार्द	friendship
स्तंभ	pillar
प्राचीनकाल	Ancient times
अवशेष	relic
समकक्ष	Of the same level or statu
भगवानों	The Gods
शरदिंदु	Sharadindu
बनर्जी	Banerjee
1932	1932
जासूस	spy
बक्शी	Bakshi
गढ़ा	hole
एक्टिवेट	Activate
मल्टीपल	Multiple
ऑपशन	Option
कनेक्टर्स	Connectors
1931	1931
इलाहाबाद	Allahabad
अल्फ्रेड	Alfred
क्रांतिकारी	revolutionary
चंद्रशेखर	One who bears the moon on his head
आजाद	Free
पुलिस	Police
घिर	Clouded
स्वयं	self
गोली	marble for playing
मारकर	By hitting
पकड़े	Holding
प्रतिज्ञा	vow
सत्य	true
एनवीडिया	Nvidia
पीरियड	period
तत्कालीन	of that time
परिस्थितियों	Circumstances
फांक	Cleft
दौर	circle
गायक	singer
शानू	Shanu
सेक्यू	Seq
S10.5	S10.5
बहरामपुर	Baharampur
पूर्वीय	eastern
तटीय	coastal
4X	4X
इंजन	engine
यूरोप	Europe
अफगानिस्तान	afghanistan
चीन	China
मंगोलिया	Mongolia
रूस	Russia
तिब्बत	Tibet
ब्राइट	Bright
शुक्रगुजार	Thankful
धूप	sunshine
पढ़ा	read
मसले	Issue
अवैधानिक	unconstitutional
मसला	question
खोकर	Lost
लखनवी	Lakhnavi
तवज्‍जो	Attention which
चेन्नई	Chennai
तंजावुर	Thanjavur
235	235
किमी	Km
गैलरी	gallery
सनकी	crazy
शास्त्री	scholar of shastra literature
जनवरी	January
फास्ट	Fast
फ्यूरियस	Furious
तीसरे	in the third place
अंत	end
पड़	Fall
करेगी	Will
MI	MI
TV	TV
40-Inch	40-inch
Full	Full
ए7000	A7000
टिपपणियों	Comments
कटाक्ष	side look
बढ़ाते	Increase
गहराते	Deep
सिंक	sink
सकेगा	Will
यूनाइट	Unite
डीटेल	Details
सुपर	super
मिनट	minute
67	67
लाइसेंस	licence
औश्र	And
रियल	Real
माजदा	Mazda
रेसवे	Raceway
लॉगुना	Logguna
सिका	Sika
लागुना	Laguna
कैलिफोर्निया	California
ट्रैक	track
ग्राहकों	Customers
जुड़	Added
पहल	initiative
चाहता	loved
भरतपुर	Bharatpur
सैंक्चुअरी	Sanctuary
1800	1800
डिम	Dim
थिकनेस	Thickness
15mm	15mm
दावा	claim
एमआइयूआइ	MIUI
भाषाओं	Languages
बंगाली	Bengali
कन्नड़	Kannada
तेलुगू	Telugu
मलयालम	Malayalam
तमिल	Tamil
सातवीं	Seventh
मेन्यु	Menu
निर्देशन	direction
संभावनाओं	Possibilities
घुट	Choking
क्रूर	cruel
हिंसक	ferocious
सर्टिफिकेट	Certificate
तर्क	argument
सुविधाओं	Features
59,990	59,990
लांच	Launch
कोर्निंग	Corning
पुश	Push
क्लाइंट	Client
4.2	4.2
*	*
कुंभ	water pot
जन	masses
संस्कृति	culture
मोटे	Coarse
सुनने	Listen
एसएमएस	Sms
आरंभिक	initial
स्वयंभू	ingenerate
नासल	Nasal
चौक	quadrangle
थेमल	Themal
नज़र	sight
फंस	complication
पार्को	Parko
बिताए	Spent
पल	moment
यादगार	memorial
विसंगति	irrelevance
कुरीति	bad custom
गहराइयों	Depths
उतर	descend
विश्लेषण	analysi
विमर्श	consultation
विशिष्ट	special
पैटर्न	pattern
निर्धारित	determined
रगेड	Raged
लैटिटयूड	Latitude
फि्लप	Philp
सहूलियत	convenience
ट्रान्सफर	Transfer
सबके	Everyone
स्‍लॉट	Slots
एक्‍पेंड	Expand
M	M
5Y10	5Y10
720	720
रेजोलूशन	Resolution
काटन	Cotton
गद्दे	Mattress
फोम	foam
बॉल	Ball
गद्दों	Mattresses
इन्द्र	Indra
कोप	anger
बारिश	rain
करा	cause
दें	Give
खिसक	Eroding
गाड़ी	cart
विंडस्क्रीन	Windscreen
रहेगी	Will
महंगा	costly
अपेक्षाकृत	comparatively
मुढ़ेंगे	Will turn around
अर्जुन	Arjun
बेबी	Baby
आतंकवाद	terrorism
समझदार	sensible
हिमालयन	Himalayan
रोपवे	Ropeway
बाहंग	Bahang
हिम	snow
फन	hood of a snake
केंद्र	centre
लिहाज़	regard
थोडा	little
फ्लश्ड	Flushed
इर्द	Around
गिर्द	Fields
काला	black
बॉर्डर	Border
गड़बड़ियां	Glitches
मात	defeat
सपना	dream
पब्बी	Pabbi
मीरा	Merry
जरूरतों	Needs
पातीं	Leaves
यूएसपी	USP
इमोशनल	Emotional
स्पेसिंग	Spacing
टाइपिंग	typing
कार्निंग	Corning
शिक्षा	teaching
3GB	3GB
क्षिप्र	fast
तीव्र	sharp
झटके	Shocks
नवीनतन	Latest
वाटर	water
रस्सिटेंस	Rassitance
आईपी	Ip
हॉक	Hawk
चोटियों	Peaks
फूनबानी	Funbani
विहंगम	bird
देखाई	Seen
11,990	11,990
डिटेल	Details
स्पष्टता	clarity
सेपरेशन	Separation
असहज	Uncomfortable
बंधे	Tied
इंटरने	Internet
पेड	tree
एक्सटरन	Exteran
दावत	invitation
इश्क	Love
तडक़ा	Early morning
मीनारों	Minarets
इमारत	building
टौरी	Tauri
8MPऔर	8MP and
फ्लोरोसेंट	Fluorescent
अंतर्गत	internal
संघर्ष	conflict
लामु	Lamu
स्वाहिली	Swahili
एक्‍पेंडेबल	Expandable
निंबज	Lemon
नेक्‍टजीटीवी	NextGTV
सावन	The fifth month of Vikrami Indian calendar
कीमत-	Value-
4,799	4,799
7.6mm	7.6mm
ईरीडर	eReader
किंडल	Kindles
वर्ष	a year
मेंहदार	Hendar
महेंद्रनाथ	Mahendranath
वार्इफार्इ	Wi-Fi
कनेक्शन	connection
इयर	Year
रंगीन	colourful
उंगलीयों	Fingers
परेशान	confounded
करनेवाला	Doer
स्‍पेशल	Special
इफेक्‍ट	Effects
नाइट	night
विज़न	Vision
सिलहोटे	Silhote
जिन्‍हें	That
स्‍टिल	Steel
बनाती	Make
पश्चिमी	westerly
शुष्क	dry
पर्णपाती	deciduou
निस्संदेह	free from doubt
प्रेरणा	inspiration
भ्रष्ट	broken
नेताओं	Leaders
एक्सपोज	Exposure
सेफ	Safe
ड्ब्ल्यूवीजीए	WVGA
480X800	480X800
नेटिव	native
पति	Husband
व्यवहार	behavior
बेवकूफाना	Stupid
गैरजरूरी	Unnecessary
कहानियों	Stories
मुश्किलों	Odds
पॉवरफुल	Powerful
ग्राफिक	Graphic
सुपीरियर	Superior
क्‍वालिटी	Quality
धड़कता	Beats
रोज़ाना	daily
कार्यों	Tasks
लिख	compose
महम	Maham
बावड़ी	A well with a flight of steps
सुपरस्मार्ट	Supersmart
गुना	time
42	42
39990	39990
मानसिकता	psyche
चाहे	whether
अफोर्डेबल	Affordable
रेड	bust
व्‍हाइट	White
ब्‍लैक	Black
पिंक	pink
आरेंज	Orange
ब्‍लू	Blue
लम्‍बाई	Length
9.5	9.5
साभी	All
फिट	fit
बैठती	Settles
इरिलिवेंट	Irrelevant
Canva	Canva
Tab	Then
P480	P480
प्रतियोगीयों	Competitors
राधिका	Radhika
आप्टे	Apte
हुमा	An imaginary bird of paradise
कुरैशी	Qureshi
प्रतिस्‍पर्धी	Competitor
घड़‍ियों	Clocks
गौर	white-skinned
सान्निध्य	nearness
सोनाक्षी	Sonakshi
सिन्हा	Sinha
निखर	Bright
इन्हीं	surely these
खपत	consumption of good
नार्मल	Normal
यूट्यूब	YouTube
किलो	kilogram
डल	Dal
झील	lake
निशात	pleasure
बाग	rein
शालीमार	Shalimar
पहलगाम	Pahalgam
कुलमिलाकर	Overall
परफॉर्म	Performance
रुकावट	hurdle
ईश्वर	lord
प्रभावपूर्ण	persuasive
स्वगत	speaking or addressing oneself
किन्तु	but
फ्रेमिंग	Framing
धीमे	slowly
नाटकीय	dramatic
प्रेमकहानी	Love Story
सवालों	Questions
टाइगर	Tiger
चीतल	variegated
जंगली	Of or pertaining to a forest
बंदर	monkey
पढ़ने	Read
लेखन	writing
प्रकाशन	illumination
अंग्रेजी	english
गाते	Sing
शेखर	Shekhar
अपवाद	false accusation
जिन्होंने	Who
एलिजाबेथ	Elizabeth
सराहना	to praise
बेस	appearance
ट्रेबल	Treble
नियंत्रण	restraint
ब्ल्यूटूथ	Bluetooth
3.5	3.5
हेडसेट	headset
जोड़ा	pair
गड़बड़	disorder
लैण्डस्कैप	Landscape
दब	Press
माइक्रोयूएसबी	MicroUSB
एल्युमिनियम	aluminium
समायोजन	adjustment
बांधते	Binding
गिरने	Falling
बर्दास्त	Tolerate
रीप्रडक्शन	Reproduction
कमोबेश	More or less
नंबर्स	Numbers
स्थितियों	Situations
उपस्थिति	presence
जीवंत	living
उठता	rising
हुईं	Happened
....	....
बताऊँ	Tell
मोहक	fascinating
इठलाती	Here
बलखाती	Strength
अदाओं	Payments
निहारने	To watch
बीता	A measure with one’s hand with the thumb and little finger stretched
ब्लड	Blood
पार्सन	Parsons
लीड	lead
रोल	role
बैठी	Sitting
पच्चीकारी	inlaying art
इराक	Iraq
श्रीलंका	Sri Lanka
पत्थर	stone
मंगाया	Replenished
इलाइटबुक	Illitbook
प्राथमिकता	priority
हों	Yes,
330	330
स्मार्टफ़ोन	smartphone
खेलों	Games
चलाता	Runs
वाइब्रेटर	Vibrator
बताता	States
मासूमियत	innocence
संलग्नता	attachment
Huawei	Huawei
टेलिकम्युनिकेशन	Telecommunication
इक्विपमेंट	Equipment
IPS	IPS
टेक्नालॉजी	Technology
विस्तृत	extended
अन्दरूनी	inward
सीपीयू	CPU
मास्टर	master
ओवर	Over
क्लॉक	Clock
1.7	1.7
मिलियन	million
बेलाग	unattached
कसैले	Astringent
अनुभवों	Experiences
घटनाओं	Events
माउस	Mouse
Pro	Pro
फूड	Food
सौंपी	Assigned
निभाकर	By playing
अहा	aha ! excellent
स्वाद	taste
इनका	Them
किफायती	economical
स्मार्टफोनों	Smartphones
;	;
प्रस्तुत	offered
एंडीज	Andes
खंडहर	ruins of a building
पशु	animal
नदियां	Rivers
होई	Yes
बंधु	kin
मुझे	me
फुवाद	Fuvad
सीखने	Learning
उद्देश्य	aim
कराया	Done
प्रत्येक	each
झुंड	herd
रेसिंग	Racing
स्नेल	Snell
बनाना	to make
कराना	To cause to be done
खड़े	Stand
गेमप्ले	Gameplay
इससें	From this
रिकॉर्डिग	Recording
तेज़ी	sharpne
HTC	HTC
One	One
M8	M8
M9	M9
उत्साह	enthusiasm
आखिर	tip
सकुशल	unharmed
ऊँचाई	height
पहुँच	arrival
प्रतिस्पर्धियों	Competitors
टाटा	Tata
स्कार्इ	Scary
एवरीह्वेयर	Everywear
ट्रायल	Trial
नोर्टन	Norton
एंटी	Anti
वायरस	virus
2.38	2.38
येरकाड	Yerkad
यरकौद	Yercaud
यूँ	Simply
होटलों	Hotels
बीसवें	The 20th
हेयरपिन	hairpin
बेंड	Bend
GRT	GRT
Nature	Nature
Trails	Trails
रुकें	Pause
भोजन	meals
व्यंजन	consonant
लजीज़	Delicious
खासतौर	Especially
SKYWALK	SKYWALK
इसपर	On this
भैंरो	Brother,
जग्गू	Jaggu
जगत	Raised circular curb of a well
जननी	mother
निवास	dwelling place
विशेषष	Special
पिछ़	Behind
जनजाति	tribe
संवर्धन	promotion
धारा	flow
जा़	
ेडने	Dene
एलेक्जेंड्रा	Alexandra
डड्डारियो	Duddario
केवलादेव	Keoladev
घना	thick
सूची	list
बसेरा	abode
व्हाट्सप्प	WhatsApp
तथ्यों	Facts
3,999	3,999
ख़ास	special
ऑफर	Offer
वसूल	acquisition
पर्वतीय	mountainous
खंडाला	Khandala
2.4गीगाहर्ट्ज़	2.4 GHz
आई7-3630क्यूएम	i7-3630QM
प्रोड्क्‍ट	Product
अच्‍छा	Good
कंप्‍टीटर्स	Competitors
टक्‍कर	Collision
स्टेबलाइजेशन	Stabilization
गियर	gear
स्पो‌र्ट्स	Sports
एमोलेड	AMOLED
विजिबिलिटी	Visibility
गुड़गांव	Gurgaon
हरियाणा	haryana
एंबिएंस	Ambience
मॉल	mall
चिल्ड्रेन	Children
इंटरैक्टिव	interactive
बेस्ड	Based
चौंकाने	Startling
सुपरहीरोज	Superheroes
कलाकारी	Artwork
रोमांटिक	romantic
ट्रेक	trek
लॉजिकल	Logical
गैप	Gap
महाशिवरात्रि	Mahashivratri
लाखों	hundreds of thousand
भक्त	divided
जलाभिषेक	Water
डयूलकोर	Dualcore
वेरियंट	Variants
फ्लैशलाइट	Flashlight
ओमलेट	Omelet
दोस्तों	Friends
डाली	branch of a tree
व्हाट्स	WhatsApp
ट्विटर	Twitter
रिस्पोंसिव	Responsive
वर्षों	Years
मेरे	my
स्मृतिपटल	Memory board
अंकित	imprint
मिथुन	couple
चक्रवर्ती	Chakraborty
कृत्रिम	artificial
बनावटी	artificial
बाॅडी	Body
शीशे	Glass
सिसे	Sise
800X400	800X400
दुखद	grievous
क्लोज	Closed
फ्रैम्स	Frames
ग्लॉसी	Glossy
टेलीविजन	television
50B5000FHD	50B5000FHD
फैमिली	Family
वर्ज़न	Version
जहाँ	world
फास्‍ट	Fast
स्‍मूद	Smooth
गीगाहर्ट	Gigahertz
4जीबी	4GB
मेगापिक्‍सन	Megapixels
वीजिए	VGA
इनबिल्‍ड	Inbuilt
सन्	year
1984	1984
20वीं	20th
जानलेवा	fatal
हादसे	Crash
वजहों	Reasons
प्रभाव	influence
समेट	Finish
Ambilight	Ambilight
कस्टमाइज	Customize
अगले	Next
हिस्स	Part
हालाँकि	though
टचपैड	Touchpad
नोटबुक्स	Notebooks
परिवहन	transport
पाउंड	pound sterling
पहुँचता	Reaches
गीगाहत्र्ज	Gigahertz
8जीबी	8GB
इंटेक	Intake
बे	Unconstrained
ट्रेल	Trail
लूप	loop
डाला	Large branch of a tree
फिजिकल	Physical
कंप्यूटर्स	Computers
पर्सनल	Personal
फोंस	Phones
एडिंटिंग	Editing
कसी	How
नम्बर	number
पंच	Member of a panchayat or village council
Twitter	Twitter
periscope	Periscope
App	App
4.4.4	4.4.4
परंपरागत	traditional
अल्ट्राबुक्स	Ultrabooks
संतोष	satisfaction
जनक	natural procreator
क्रैश	crash
आईवॉच	iWatch
भेजे	Sent
329	329
अमेज़न	Amazon
फायर	fire
199	199
लिंग	male genital organ
च्योतिर्लिगों	Chiotlerlings
गुल	flower
पनाग	Panag
बच	Escape
रीयल	Real
डेड	dead
ट्रिगर	trigger
एंग्री	Angry
बर्ड्स	Birds
49	49
49990	49990
गुणवत्तापूर्ण	Quality
लीग	league group
थोड़े	a few
गन्स	Guns
पहाड़ियां	Hills
लुभावने	Breathtaking
पिकनिक	picnic
दिव्येंदु	Divyendu
कॉमिक	Comic
अवतार	incarnation
विद्रोही	rebel
असर	effect
छोड़ता	Leaves
भूरे	Brown
लैदर	Leather
पट्टे	Lease
लुभाएगी	Will be tempted
इम्प्रूव	Improve
उपयोगिता	usefulness
1.2GHz	1.2GHz
Qualcomm	Qualcomm
Snapdragon	Snapdragon
SoC	SoC
उठाते	Take
मिमी	Mm
यूएसवी	USV
साकेट	Sacket
पोर्टस	Ports
गांव	village
स्वरुप	Format
सत्यवती	Satyavati
दिव्या	nymph
मेनन	Menon
जंचती	Check
झेल	Afford
डूबो	Drown
संसद	parliament
पर्यावरण	environment
स्थायी	permanent
समिति	committee
निरीक्षण	observing
पडऩे	To fall
मुहर	seal
सुरम्य	extremely charming
रिजर्वो	Reserves
आंतरिक	internal
साज	embellishment
सज्जा	adoration
शिल्पकारी	craftsmanship
विशाल	large
गुंबदों	Domes
कदम	step
खन्ना	Khanna
भौंचक्का	amazed
जोर	effect
सुरुचिपूर्ण	refined
छोड़	abandon
1995	1995
पृष्ठभूमि	background
राजनीतिक	political
रेफरेंस	Reference
बचाने	Save
सुस्त	lazy
गैर	foreign
हमनें	We
देखी	Seen
खेला	Played
हेंडसेट	Handset
सुने	Heard
बिहार	Bihar
बिखरी	Scattered
पड़ी	Lying down
शुकून	Dry
कॉलर	collar of a garment
सूचना	information
अत्यावश्यक	urgent
मिस	pretext
कम्पाइटेबिलिटी	Compatibility
आर्इफोन	iPhone
आर्इओएस6	IOS6
आर्इओएस7।	IOS7.
पड़ती	fallow land
क्‍लाइंट	Client
मेसेंजर	Messenger
push	Push
mail	Mail
client	Client
and	and
messenger	Messenger
4325	4325
7-8	7-8
लॅग	Lag
चुके	Have
बढिया	fine
चुनें	Select
सेटअप	setup
बारहवें	Twelfth
ज्योतिर्लिग	Jyotirlinga
जानते	Know
लोगो	logo
सफ़ेद	white
आमतौर	Usually
सिंतबर	September
खुलती	Open
विकी	Wiki
सदाना	Sadana
कास्टिंग	Casting
गानों	Songs
लचर	ineffective
40	40
हैंडहेल्ड	Handheld
नैसर्गिक	natural
दीदार	sight
बैगाओं	Bagao
परंपरगत	Traditional
नजदीक	near
शेप	shape
मर्दाना	masculine
रिहाना	Rihanna
जेनिफर	Jennifer
लोपेज	Lopez
स्टीव	Steve
सेलेब्स	Celebs
रिकॉर्ड	record
MHz	MHz
1080p	1080p
डेफिनिशन	Definition
कॉन्टेंट	Content
मजे	Interesting
कॉनटेंट	Content
स्कीन	Skin
महात्मा	A holy or pious man
ज्ञान	knowledge
मामलों	Cases
मध्यम	medium
सुपरफोन	Superphone
दर्जा	rank
पुलतियों	Pulleys
हरकत	motion
पढ़कर	Read
सहूलिसत	Convenient
सहारे	Support
डांस	Dance
सीक्वेंस	Sequence
प्लैक्स	Plex
एक्सबीएमसी	XBMC
मज़ा	pleasure
उठाया	Raised
जानकारी	knowledge
नमी	dampness
रखेगी	Will
माइक्रामैक्स	Micromax
ज्यूस2	Juice2
फॉन	Fon
मैटेलिक	Metallic
मेहता	Mehta
निभाई	Played
कीपैड	keypad
टाइप	sort
व्यावहारिक	practical
निकलकर	Get out
डरने	Fear
सादा	simple
स्थिर	steady
विश्वशनीय	World
कर्व्ड	Curved
रिप्रोडक्शन	Reproduction
सनलाइट	Sunlight
रुचि	interest
इनकी	Their
बदौलर	Badular
फोटोग्राफर	photographer
वेरियड	Varied
वन्य	wild
सुल्तानगंज	Sultanganj
गंगाजल	Sacred water of the Ganga
105	105
पैदल	on foot
तय	agreed
जल	water
अर्पित	offered
सकनेवाली	Capable
फायदेवाली	Beneficial
नंदा	Nanda
देवी	Title of reverence to a respectable lady
द्ब्रलावर	On the drums
सम्मिलित	compound
1988	1988
टूल्स	Tools
जिनसें	From whom
कलाकार	artist
नाथ	lord
गाड़ी	cart
20.7	20.7
सीमॉस	CMOS
जिनॉन	Jinon
1.8	1.8
स्किल्स	Skills
बढ़ाना	to increase
चहते	Tea
प्रीलोडेड	Preloaded
सॉफ्टवेर	Software
बोझिल	heavy
राजेन्द्र	Rajendra
केके	KK
रैना	Raina
दीप्ति	splendour
मिश्रा	Mishra
नवनी	butter
परिहार	avoidance
कम्प्यूटर	computer
कॉम्पैक	Compaq
ब्ल्यू	Blue
किट्स	Kits
परखा	Tested
षमिताभ	Shamitabh
गूंगे	Dumb
शख्स	person
सुपरस्टार	superstar
बोरिंग	Boring
इसें	This
पार्ट्स	Parts
15,000	15,000
आस	hope
डस्ट	Dust
जोलो	Jolo
5.0	5.0
जीने	Live
फॉर्मेट	Format
बदले	Instead
करोली	Karoli
पत्थरों	Stones
ख़ूबसूरत	beautiful
दिगंबर	Digambar
तीर्थंकर	Tirthankara
आदिनाथ	Adinath
लायक	worth
लमहे	Lamhe
कैद	captivity
सका	Could
खुशकिस्मती	Good luck
युसेज	Usage
कॉल्‍स	Calls
टेस्टिंग	Testing
खंभों	Pillars
खड़ा	standing
जोड़	joint
कंधमाल	Kandhamal
मुख्यालय	headquarter
जीएसम	GSM
मुन्नार	Munnar
देखकर	Seeing
धरती	earth
ऑपरेशन	operation
एप्लिकेशंस	Applications
6999	6999
स्पेशीफिकेशन	Specification
प्वाइंट	Point
3700	3700
टैबलेटों	Tablets
300-शॉट्स	300-shots
सयानी	Sayani
रेवती	Revati
बराबर	equal
हाईवे	Highway
गुजरने	Passing
नशे	Drunk
जरुरत	indispensability
ऊर्जावान	powered
चिढ़ानेवाला	Teasing
चीजों	Things
टाइप्स	Types
नतिजे	Results
निकले	Ventured
इंस्ट्रूमेंट	Instrument
संभाल	lead
स्मार्टफोन्स	Smartphones
.9	.9
640	640
तुलनात्मक	comparative
प्रभु	God
देवा	Deva
यकीन	kindness
अहसास	feeling
4.2.1	4.2.1
आउट	out
राजमार्ग	highway
17	17
पाँवेल	Powell
मुम्बई	Mumbai
कोच्चि	Kochi
582	582
सड़क	road
महाराष्ट्र	Maharashtra
कर्नाटक	Karnataka
जोड़ती	Combines
विलेन	Villain
जुलता	Similar
Google	Google
भरोसा	reliance
ठीकठाक	All right
चाहने	Wanting
कन्ज्यूमर्स	Consumers
सुपरहिट	Super hit
मछिलयों	Fish
काउंट	count
दुरुपयोग	abuse
काई	water-moss
कारणवश	Due to a certain cause
टीबीवी	TBV
निश्चत	Sure
15,990	15,990
नाना	mother’s father
पाटेकर	Patekar
साधु	saint
आगाशे	Agashe
गजब	Amazing
नजारा	view
थोड़ी‍	small
थोड़ी	small
उफनते	Boiling
जलप्रपात	waterfall
विंड	Wind
टकराती	Collision
मोटी	fat
बूँदे	Drops
काली	goddess Kali
लकीर	line
अगल	Separate
चहलकदमी	walk
बादल	cloud
मोहती	Mohti
अदभुत	Amazing
मौके	Spot
अदाकारी	performance
संतुष्ट	satisfied
कंचनजंगा	Kanchenjunga
बाँटने	Share
नाथू	Nathu
युकसोम	Yuksom
भद्दा	unsightly
आवरणों	Coverings
कॉम्पोनेंट्स	Components
न्यजीवों	New creatures
चुस्त	brisk
किसने	who
S60	S60
सेल्‍फी	Selfies
फिक्‍स	Fix
475	475
मद्देनजर	Wake
क्लसिक	Classic
रेट्रो	Retro
बल्ब	Bulb
डबल	double
मेक्रो	Macro
हाइपरफोर्मेश	Hyperformesh
फ्लेश	Flash
जुझारू	Combative
सहयोगी	colleague
प्रवृत्ति	tendency
प्लेयर्स	Players
पड़ते	Falling out
4.8	4.8
सुपरअमोलेड	SuperAMOLED
फंक्शन्स	Functions
सिवा	Except
ड्रॉअर	Drawer
बारीकीयाँ	Nuances
मिट	Erased
प्रमाण	proof
जटिल	tangled
एक्सरप्रेशन	Exercise
सिस्‍टम	System
उपदेशों	Teachings
यहीं	at this very place
लिपिबद्ध	written
बौद्ध	Buddhist
संगीति	Council
इनबॉक्स	Inbox
ज़गह	Place
रिम	rim of a wheel
दिलाती	
जोरदार	vigorous
विजन	lonely
10.52x7.36x0.34	10.52x7.36x0.34
622	622
खींची	Drawn
XT811	XT811
XT911	XT911
दाए	Right
SD	SD
स्थितियां	Conditions
थर्ड	Third
पार्टी	party
विंदोज	Windows
माइंडलेस	Mindless
मसाला	spice
तंज	Tanj
कसते	How
आड़े	Hurdles
डोगल	Dougal
रीडर	reader
अत्यंत	excessive
असुविधाजनक	inconvenient
इन्स्टाग्राम	Instagram
फिल्टर्स	Filters
आलावा	In addition
संरचना	structure
कलाओं	Arts
समेटे	Contain
महिनों	Months
ऑफरों	Offers
गुठलियों	Kernels
सामंती	feudal
समझ	understanding
मानो	suppose
भूमि	land
अली	Ali
फजल	Fazal
कबीर	big
हथेली	palm of the hand
सहायता	aid
मेटालिक	Metallic
टिकाऊ	durable
वादा	promise
सॉलिड	Solid
RIM	RIM
क्वॉलकोम	Qualcomm
स्नैप	Snap
ड्रैगन	dragon
मुकदमे	Trial
कलाई	wrist
बिल्‍कुल	Absolutely
12.2	12.2
इफेक्टिव	Effective
एक्समोर	Exmore
बियोन्ज	Beyoncé
अलावाइस	Apart from this
मीडियाटेक	MediaTek
512MB	512MB
जापान	Japan
संघ	association
स्तूप	A dome-like monument especially one erected over the remains of a saint or high personality as Lord Budḍha
करवाया	Orchestrated
आजकल	nowadays
मूख्य	Main highlights
एस70	S70
रिव्यू	revue
लॉकेट	locket
आइरिस	Iris
ओवरऑल	Overall
बेमिसाल	unparalleled
बख्शी	Lends
थंडरबोल्ट	Thunderbolt
3.5एमएम	3.5mm
हेडफोन	Headphones
सॉकेट	socket
स्‍ट्रेप	Strep
चेंज	change
नेट	net
ब्राउज	Browse
ब्राउजर	Browser
आधे	Half
रबर	rubber
आईकैप	iCap
जाँच	test
नियंत्रित	controlled
सपूर्ण	Complete
निकट	near
वॉचऑन	WatchOn
मैनेज	Manage
आंखें	Eyes
खुली	Open
ऊंचे	High
झोपड़ा	Cottage
फातरू	Fatru
गर्मी	heat
सर्दी	Chill
कराता	Do it
1050	1050
रिचार्जेबल	Rechargeable
लिथियम	lithium
एए	Aa
हटकर	Away
डॉल्बी	Dolby
एट्मॉस	Atmos
सुनेंगे	Hear
प्लेटफॉर्म	Platform
बदलना	to change
फ्रेंड्सलिस्ट	Friends List
रोकती	Prevent
पुरुषोत्तम	best of men
बेबस	helple
सिद्धांतों	Principles
अडिग	steady
हपोली	Hapoli
जंगलों	Forests
विदेश	foreign country or land
उर्जा	life
दीवाल	wall
जड़े	Roots
नगीने	The naked
संध्या	evening
व्यक्तित्व	personality
छुपे	Hidden
पहलूओं	Aspects
लाती	Induces
सिलिकॉन	silicon
जागिंग	Waking up
पसीना	perspiration
चिपकता	Adhesives
वजब	Wow
दिक्‍कत	Trouble
यशराज	Yash Raj
फिल्म्स	Films
सहयोग	cooperation
इंटरफ़ेस	interface
भूपलम	Bhoopalam
गीतकार	composer of a song
शकील	well-shaped
आजमी	Azmi
तोषी	satiated
शारिब	Sharib
डूडल	Doodle
एक्स्पीरियंस	Experience
फिल्मे	Films
प्रसंग	context
तार्किक	logical
मंत्र	spell
रखेंगे	Will
भोलेनाथ	Bholenath
श्रृंगार	erotic sentiment
दस	the numerical figure ten
हड़प्पा	Harappan
कालीन	Of or belonging to a certain time
पुरास्थल	Archaeological site
दक्षखेड़ा	Dakshkheda
बीते	Past
जमाने	Age
चुकी	Mistake
सेवाओं	Services
वास्वत	In fact
लुभाने	Entice
नेक्सट	Next
जीटीवी	GTV
इंजेनिक	Engineic
उजागर	splendid
2048	2048
1536	1536
जैक्लीन	Jacqueline
फर्नांडीस	Fernandes
केन्या	Kenya
प्राचीनत	In the ancient
युग	pair
स्लेट	slate for writing
नौकरशाही	bureaucracy
आदमी	man
समीकरण	equalization
गूढ़	concealed
पड़ताल	thorough search
कठिनाई	difficulty
अनुवाद	Translation
ट्रांसलेशन	Translation
टूल	twill
वेद	knowledge
पुराण	ancient
रामायण	The epic describing the life of Rama
महाभारत	a great war
प्रयाग	Prayag
नेपाल	Nepal
नाचते	Dance
गातेे	Sing
मस्ती	drunkenness
जोखिम	risk
निडर	fearless
टकराते	Collision
नायिका	Heroine of a drama or story
दिखाते	Show
एप्लायंस	Appliance
कोरिया	Korea
8.1	8.1
मॉडेम	modem
देखेने	To see
घुमाकर	By turning around
400एमपी	400MP
Hairline	Hairline
Brush	Brush
Finish	Finish
लग्जरी	Luxury
जैव्लरी	Jewellery
ड्यूअल	Dual
power	Power
key	.key
करनी	deed
चिकना	oily
निकालने	Remove
उपर	up
एक्सपांशन	Expansion
दिखेगा	Look
लॉगइन	Login
ओपन	Open
रेल	rail
राडार	Radar
Rail	Rail
Radar	Radar
ट्रेन	Train
मैप्स	Maps
Maps	Maps
एप्लिकेंशंस	Applications
अटैचमेंट	Attachment
साइनईजी	Signee
खोला	Opened
मधुरता	sweetne
256	256
गंम्भीर	Serious
पहाड़ी	hill
सड़कों	Streets
पॉवरअप्स	Powerups
सिक्के	Coins
ऐल्युमिनियम	Aluminium
यूनिबॉडी	Unibody
मार्क्स	Marx
G500	G500
निकलता	Implies
उंग्लियों	Fingers
गंदा	dirty
नजरिए	Perspective
बटन्स	Buttons
फोर	Four
सीधी	straight
चोट	hurt
सस्पेंस	Suspense
मर्डर	Murder
भूत	ghost
प्रेत	ghost
सेक्स	sex
रोमांस	romance
किस्में	varieties
छटा	beauty
जलपान	snack
रुक	stop
नज़ारों	View
भूलें	Forget
तभी	at that very moment
ठंडा	cold
सबकुछ	Everything
39.5	39.5
सेकेंड	Secs
बूटअप	Bootup
micromax	Micromax
नवीनतम	up-to-date
बाज़ार	market
फाइव	Five
स्टार	star
एडिटर्स	Editors
चॉइस	Choice
समलैंगिक	gay
नियोप्रीन	Neoprene
पाउच	pouch
माइक	Mic
हैडफोन	Headphones
गार्ड	guard
एडवेंचर	Adventure
प्रॉम्प्ट	Prompt
शॉर्ट	Short
लर्निंग	Learning
कर्व्स	Curves
pixel	Pixels
रिजॉल्‍यूशन	Resolution
348ppi	348ppi
बैकलिट	Backlit
बोनस	Bonus
रात	night
तकनीशियन	technician
संपर्क	contact
शेष	remaining
गुणवता	Quality
इन्टेल	Intel
आकारों	Sizes
मूल्यों	Values
लाये	Brought
छप्पन	fifty-six
इर्म्‍पोटेंट	Irm Potent
प्रॉडक्‍ट्स	Products
स्‍मार्टफोन	Smartphones
कॉम्‍पेटिबल	Compatible
वेट	Weight
स्वभाव	innate disposition
टर्न	Tern
ट्विस्ट	Twist
दिसंबर	December
1985	1985
मान्यता	accreditation
शनिवार	Saturday
संसदीय	parliamentary
ताज	crown
नष्ट	perished
समानता	equality
जताई	Expressed
Corning	Corning
Gorilla	Gorilla
Glass	Glass
कहें	Ask
बाजपेयी	Bajpayee
ऊंचा	high
टुमारोलैंड	Tomorrowland
ब्रेड	Bread
अनलिमिटेड	Unlimited
हार्डकोर	Hardcore
मठों	Monasteries
रखरखाव	maintenance
बौद्धधर्मी	Buddhists
47	47
स्पेन	Spain
44	44
फ्रांस	France
जर्मनी	Germany
मैक्सिको	Mexico
मेसेजेस	Messages
कोमैनेज	Comage
मिरासोल	Mirasol
240	240
एंपियर	Ampere
ऑवर	Hour
नागरिक	civic
आहत	hurt
त्रिकोणीय	triangular
ढक्कन	lid
अंदर	inside
नियमानुसार	according to rule
खोली	covering
कहानियां	Stories
खुलता	Open
369	369
हर्ट	Hurt
मॉनिटर	monitor
क्वॉलकॉम	Qualcomm
S4	S4
प्रोसेसर,384	Processor,384
मेगाहर्त्ज	MHz
एड्रिनो	Adreno
गौरव	glory
सोलंकी	Solanki
स्पाडर	Spader
इलाके	Terrain
सुंदरीकरण	Beautification
मुग्धकारी	charming
प्रतिभाएं	Put
निखरते	Shining
10,000-15,000	10,000-15,000
जाप	Adoration by repeating phrases or mantras from scriptures
उपचार	medical treatment
मनगढ़ंत	concocted
अतुल्य	without an equal
महानगरों	Metros
व्यवाहारिक	Practical
ज़ूम	Zoom
अजमेर	Ajmer
उर्स	Muslim saint’s death anniversary
चादर	sheet of cloth
चढ़ाने	Galvanization
4:3	4:3
अनुपात	ratio
माफिक	Mafiq
बशर्ते	provided
16:9	16:9
16:10	16:10
एड्रेनो	Adreno
सामान्यतया	Typically
पैक	pack
डलवाना	To cause to be put
रिक्शा	rickshaw
टैक्सी	taxi
भुवनेश्वर	Bhubaneswar
211	211
165	165
कटक	army
172	172
साइज़	size
पकड़े	Holding
अभाव	want
परशानि	Parshani
लॅग्ज	Luggage
दिखें	Visible
डुबकी	dive
धन्य	blessed
समझते	Understand
मनीकरण	Manikaran
रास्ते	Way
कसोल	Kasol
भुंतर	Bhuntar
कुल्लू	Kullu
वैष्णों	Vaishno
अंगोरा	angora
फिश	Fish
तल	surface
5602	5602
18,380	18,380
दर्रा	mountain pa
ऊँचा	high
सुंदरी	nymph
Mi	Mi
Band	Closed
एक्‍टीविटी	Activity
ट्रैकर	Tracker
वर्क	Work
सुविधनुसार	As per convenience
कैरेक्टर	Character
कैरीकेचर	Caricature
कंगना	bracelet
रनौत	Ranaut
रणदीप	Randeep
हुड्डा	Hooda
समर्थ	capable
समर्थन	support
खड़ी	Steep
कृषिका	Agriculture
लु्ल्ला	Lullah
गवाही	evidence
लूमिक्स	Lumix
जीएच4	GH4
मिलने	Meet
जैव	Relating to life or living objects
इन्टरनेट	Internet
जिओनी	Gionee
फेमस	Famous
धनुष	bow
अमिताभ	Amitabh Bachchan
बच्चन	Bachchan
बुलंद	high
चेहरे	Face
हाव	Greed
कैरी	small unripe green mango
हैडसेट	Headset
अनुमानित	supposed
निर्धारण	determination
तगड़ी	Strong
प्रतियोगी	competitive
मौलिक	original
हटाते	Delete
टूट	breakage
धार्मिकता	piety
पहलू	side
रूपांतरण	transformation
बैठने	Sit
गलत	wrong
मत	opinion
समझे	Got
परन्तु	but
एंटरटेनमेंट	Entertainment
एक्सपीरियंस	Experience
चित्तौड़गढ़	Chittorgarh
कस्टम	custom
पल्लवी	sprouting
शारदा	Saraswati
कुशल	expert
नृत्यांगना	Dancer
डब्बावाला	Dabbawala
कार्यालयों	Offices
सप्लाई	supply
चैन	Chain
मैनेजमेंट	management
एक्‍स	X
पिक्‍स	Pics
नैनों	Nanon
एडजस्‍ट	Adjust
होल	hole
बटन्‍स	Buttons
प्रोडक्शन	Production
डिजाइनर	designer
कैमरामैन	cameraman
परिवेश	environment
डब	pouch
होंठ	lip
मिलाने	Shake
ब्राउसर	Browser
भरने	Fill
कॉपी	copy
पेस्ट	Paste
3840	3840
2160	2160
प्रतियोगियों	Competitors
कंबीनेशन	Combination
सीएडी	Cad
बढ़ना	to increase
बर्बाद	ruined
आएगा	Will
संतुलन	balance
स्टैबिलाइजेशन	Stabilization
अधिकारी	officer
यात्री	traveller
ईवॉलेट	eWallet
काउंटर	counter
आईआरसीटीसी	IRCTC
वेबसाइट	Website
क्रेडिट	credit
डेबिट	Debit
इलैयाराजा	Ilaiyaraaja
कर्णप्रिय	pleasing to the ear
शॉपिंग	Shopping
बकवास	
अजीबोगरीब	twilight
पिरो	Piro
धड़	body of a person
ठिकाने	Whereabouts
सरगना	ringleader
पहुंचती	Harmed
नाउ	Now
पर्फॉर्मेंस	Performance
पहनते	Wear
समीक्षा	review
अमूमन	generally
चोर	thief
कोलाबा	Colaba
कॉजवे	Causeway
फैशन	fashion
साजो	Logistical
सजावट	adoration
यूएस	US
48,984	48,984
मनाए	Celebrate
पर्व	knot
मार्च	March
मनाया	Celebrated
म्योको	Mayoko
त्यौहार	festival
मुरुंग	Murung
जुलाई	July
द्री	Dri
फैले	Spread
बागान	Plantation
घाटियां	Valleys
चोटियां	Peaks
खुशबू	fragrance
हवा	air
सुकून	peace
ग्रैंड	Grand
जोड़ने	Add
चटके	Cracks
S6	S6
Edge	Edge
फैक्टरी	factory
क्षैतिज	horizontal
खुलते	Open
लैंडस्केप	Landscape
बाध्य	compelled
एक्‍सपीरिया	Xperia
ज़ी	zee
क्‍वालकॉम	Qualcomm
क्‍वॉडकोर	Quadcore
1920x1200	1920x1200
रेज्‍यूलूशन	Resolution
क्‍लियर	Clear
हाईडेफिनेशन	High definition
व्‍यू	View
प्रोवाइड	Provide
रिपोर्ट	report
100,000	100,000
निर्मल	Free from dirt or impurities
रिकॉ​र्डिंग	recording
रफ्तार	speed
जोड़ी	couple
तीसरी	Third
पैकेजिंग	Packaging
सिमकार्ड	SIM card
dongle	Dongle
पकड़ा	catch
लापरवाहियों	Negligence
अति	very much
घंटों	Hours
जोड़े	Couples
सुहाने	Nice
बर्फीली	Snowy
एआरएम	Arm
कार्टेक्स	Cortex
पावरवीआरएसजीएक्स	PowerVRSGX
531	531
बीचों	In the middle
चट्टानों	Rocks
जाल	net
बौनी	Dwarf
इजाफा	Uptick
उड़ना	Take off
लात	leg
मारना	to beat
बिल्डिंग	building
चढ़ना	To climb as on a tree
मुक्के	Boxes
रेकमेंडेशन	Recommendation
ऎसा	Such
एसी	AC
कंडीशनर	conditioner
ठंड	cold
मच्छर	mosquito
भगाने	Escape
फ्रीक्वेंसी	Frequency
टू	To
फ्लैट	flat
लोअर	Lower
डिप	dip
मिड	Mid
रेंजेज	Ranges
स्टीप	Steppe
सोरिंग	Soring
सर्फिग	Surfing
वर्ड	Word
कार्यो	Tasks
शिमित	Shimit
अमीन	a petty revenue officer
2004	2004
रास्तों	Paths
उतरना	to get down
पड़ेगा	Have
चढ़ाई	ascent
चढ़नी	Climb
पड़ेगी	Will fall
श्रद्धा	devotion
अदायगी	payment
विफल	fruitless
स्लोफो	Slowfo
इंस्टाबाउंस	Instabounce
छूट	abatement
विस्मयकारी	surprising
11,060	11,060
भिड़ती	Clash
सुला	Sula
ज़्यादातर	more than half
खंडहरनुमा	Ruined
एंव	And
कारीगिरी	Craftsmanship
खंबे	Pillars
छत	roof
क्लेरिटी	Clarity
डाइरेक्ट	Direct
साझा	partnership
आशुतोष	One who is easily pleased
राणा	Rajput king in Rajasthan and Nepal
अखिलेंद्र	Akhilendra
सुनील	Sunil
शेट्टी	Shetty
बिहारी	roaming
दंपत्ति	Couple
नैचुरल	Natural
जैगम	Jagam
इमाम	Muslim spiritual or religious leader
रिस्पांस	Response
एडवर्डियन	Edwardian
क्रॉप	Crop
रोटेट	Rotate
शेयरिंग	Sharing
इफेक्ट	Effects
डालना	to throw down
प्रचीन	Ancient
शहरों	Cities
पाइन	Pine
पेड़ों	Trees
आचार	conduct
समर्थक	seconder
सत्ता	existence
स्वीकार	act of accepting
कालांतर	interval of time
समूहों	Groups
बांधे	Tied
दशहरा	Dussehra
अखंड	whole
भजन	devotional song
संकीर्तन	congregational singing
पाठ	lesson
सोमनाथ	A place of pilgrimage in Gujarat
अहिल्याबाई	Ahilyabai
प्रभास	Prabhas
पाटन	roofing
संग्रहालय	museum
जूनागढ़	Junagadh
800×480	800×480
आईस्‍क्रीम	Ice Cream
3200	3200
डब्‍लूवीजिए	WVGA
घने	Dense
देवदार	cedar tree
गंतव्य	to be reached
CM	CM
ROM	.ROM
मौजुदा	Existing
रॉम	ROM
कभार	Occasional
ऍप	App
एसएसडी	SSD
500जीबी	500GB
अनुमान	guess
प्लॉट	plot of land
है-	Have-
स्‍टाइलिश	Stylish
यंग	young
स्‍टेटमेंट	Statement
मैच	match
2800	2800
आवश्यक	necessary
रोटियां	Loaves
रोटी	bread
तेल	oil
बनाकर	By making
एडजेस्ट	Adjust
एडवर्टाइजमेंट	Advertising
जीत	victory
लेगा	Will
लगेंगी	Will be
सॉफ्टवेयर	software
2HDMI	2HDMI
प्रूफ	proof
टैक्सट	Taxes
पकाने	Cook
ऑडर	Order
एकड़	acre
रहस्यमयी	Mysterious
द्रविड़	Dravidian
वास्तुकलाशैली	Architecture
दर्शाता	Showing
MPEG	.MPEG
H.264	H.264
डिकोडर	Decoder
स्टोर	store
बूंद	drop
बहाना	pretext
यूनिट	unit
कर्व्‍ड	Curved
डिस्‍प्‍ले	Display
अंतर्राष्ट्रीय	international
हवाई	a kind of firecracker
अड्डा	Hang out
नजदीकी	near
रेम	Rem
1730	1730
जल्द	quickly
4.4.2	4.4.2
दृश्यता	visibility
ऑटोमेटिक	Automatic
इंप्रूव	Improve
1911	1911
बढ़े	Enlarged
टिल्टिंग	Tilting
हानि	disadvantage
प्रतिभागी	participant
छात्रावासों	Hostels
ठहराया	Ordained
हलका	light
खाते	Account
गुण	quality
जोड़ता	Adds
दोबारा	once more
पनपेगी	Will thrive
स्वाभिक	Naturalistic
1280x768	1280x768
332	332
घनत्व	density
पेशकश	Offer
6441	6441
बाते	Things
अक्षय	undecaying
पत्नी	Wife
कांफ्रेंस	Conference
जिक्र	discussion
आटा	flour
सारा	all
8GB	8GB
पेंटैक्स	Pentax
शौकिया	amateur
असली	genuine
ऑफिसियल	official
1टीबी	1TB
नंदन	one who delight
छोर	border
एप्‍पल	Apple
एक्‍सपर्ट्स	Experts
कन्‍फ्युजिंग	Confusing
सुपरस्मार्टफोन	Supersmartphone
मुख्यतः	mainly
कसौटियों	Tests
कसा	How
Chip	Chip
Computer	Computer
ऑलविनर	All-Winner
एसओसी	SOC
मानदंडों	Criteria
स्टॉर्म	Storm
आइकॉन्स	Icons
एप्प्स	Apps
3600	3600
फोनों	Phones
तुलन	weighing
पार्ट	part
डिफॉल्ट	Default
इनबिल्ट	Inbuilt
विस्तार	expansion
फलियों	Bean
लदी	Laden
मिर्च	chillie
लताएँ	Vines
अचानक	suddenly
गलती	wrong
पड़ी	Lying down
रामपाल	Rampal
गलतफहमी	misunderstanding
उचट	High
बेपरवाही	heedlessness
निचोड़	essence
आगर	Agar
बातचीत	conversation
उठाना	to lift
पवेलियन	Pavilion
dv6	dv6
6100	6100
आई7	I7
चुन	Choose
इनडिविजुअल	Individual
पूर्णावतार	perfect incarnation
श्रीकृष्ण	Shri Krishna
आदेश	order
विश्वकर्मा	demiurge
नगरी	a small town
मथुरा	Mathura
यादवों	Yadavs
लाकर	Bringing
बसाया	Settled
टाइमर	Timer
112	112
पठार	plateau
सतह	surface
2024	2024
सीरी	a cropper
टेक्‍नोलॉजी	Technology
मुख्‍यता	Mainstay
ट्रांस	Trans
सीएमओएस	CMOS
गेटवे	gateway
इंडिया	India
छत्रपति	monarch
शिवाजी	Shivaji
टर्मिनस	Station at the end of a railway or bus route as Mumbai
जुहू	Juhu
चौपाटी	Chowpatty
जगहें	Sights
रेसोल्यूशन	Resolution
ढूढ़	Find out
संतुलित	balanced
इसकर	This is
रिफलेक्टिव	Reflective
रोटीमेटिक	Rotimatic
प्रनोती	Pranoti
नागरकर	Nagarkar
रिषी	Rishi
ईरानी	Iranian
वरुण	Neptune
धवन	Dhawan
एक्टर	Actor
हिमालय	the Himalayas
नगर	town
यूनेस्को	UNESCO
धरोहरों	Heritage
आधा	half
अर्नाल्ड	Arnold
सीरियस	Serious
s	s
Remote	Remote
मार्वल	Marvel
फैंस	Fans
ट्रीट	Treat
हास्य	laugh
शालीनता	noble behavior
1280x800	1280x800
आइपीएस	IPS
भीड़	crowd
देवाधिदेव	god of gods
सर्वोच्च	paramount
देवता	god
पूजने	Worship
उपासकों	Worshippers
तमिलनाडु	Tamil Nadu
नटराज	king of dance
आस्था	faith
दस्तक	a knock
बिताते	Spend
नेचूरल	Natural
लेंग्‍वेज	Language
आईडेंटिंफिकेशन	Identification
इंटरप्रेट	Interpret
प्रॉब्‍लम	Problem
वेरियंट्स	Variants
वॉरंटी	Warranty
आप्टिमस	Optimus
तिब्बती	Tibetan
भूटानी	Of or pertaining to Bhutan
ठहर	stay
संपदा	estate
जनजातीय	tribal
यात्रियों	Passengers
निर्दोष	faultless
सर्फिंग	Surfing
रोग	disease
जोक	Joke
कैनवास	canvas
नीट्रो	Nitro
i5	i5
परफार्म	Performance
दौड़ें	Run
भागें	Run away
कूदें	Jump
टाइमिंग	Timing
होनी	destiny
ग्रेविटी	Gravity
प्रोक्सिमिटी	Proximity
असेलेरोमीटर	Ascelerometer
किशोर	teenager
बाल	ear of corn
कटवाते	Cut off
पॉपअप	Popup
पासवर्ड	Password
अलर्ट्स	Alerts
चालू	cunning
सेशन	session
कछुओं	Turtles
मछलियों	Fishes
उभयचरों	Amphibians
भू	land
स्खलन	stumbling of speech
शिरों	Shiron
पोरट्रेट	Portrait
इनके	Their
एसफाल्ट	Asphalt
डॉक्स	Docs
लिखते	Write
DDR3	DDR3
अभ्यास	practice
हिन्ज़	Hinz
टाइट	tight
इसीलिये	That's why
पोजीशन	Position
परिष्कृत	refined
विक्डलीक	Wikdlik
एकसीलरेटर	Accelerator
एमवी	Mv
एडब्लू	AWw
ए10	A10
ए8	A8
1.2गीगाहर्टज	1.2 GHz
कोरियाई	Korean
व्हाटएवर	What's on
नकल	duplicate
संस्कृतियां	Cultures
लाचेन	Lachen
रास्ता	path
पथरीला	stony
कालिंग	elephant
सरल	simple
लूक	falling or shooting star
सम्मानजनक	respectable
स्पर्धात्मक	Competitive
खरीदा	Bought
दानेदार	granular
पकड़ने	Catch
ग्रिप	Flue
आईकान	Icon
बेस्‍ड	Based
सर्कुलर	circular
गोरिल्‍ला	Gorilla
ग्‍लॉस	Glass
करहे	Do it
मन्दिर	temple
पीपल	the holy peepal tree
वृक्ष	tree
सरोवर	lake
संग्रहालयों	Museums
महाबोधी	Mahabodhi
भिक्षु	friar
कस्बा	town
नामांकित	marked with a name
रोक	stop
भ्रष्टाचार	corruption
नेता	leader
बिजनेश	Business
सम्मानित	honoured
जेल	jail
सजा	punishment
काट	cut
2.7जीएचजेड	2.7GHz
805	805
मुसलमानों	Muslims
धारणाओं	Perceptions
मिथकों	Myths
संवेदनशील	sensitive
शार्पनेस	Sharpness
सार	iron
डिस्टर्ब	Disturbed
निभाने	Play
उधेड़बुन	indecisiveness
यों	Yon
प्रकट	evident
टहलना	walk
आनंददायक	pleasant
ईमेल	email
हैकर्स	Hackers
पढ़ना	to read
नामुमकिन	impossible
कान	ear
छेद	hole
प्रतिरोध	obstacle
सकारात्मक	positive
कूलर	cooler
दबाने	Pressing
रवींद्रनाथ	Rabindranath
पारंपरिक	traditional
ढांचे	Framework
लेदर	leather
टेक्सचर	Texture
टैबलेटें	Tablets
4-5	4-5
परर्फोंमेंस	Performance
कमियाँ	Shortcomings
तीर्थस्थल	Pilgrimage site
रेसॉर्ट	Resort
सहयाद्रि	Sahyadri
घाटियों	Valleys
तेंदुआ	leopard
भालू	bear
नीलगाय	Nilgai
मोर	peacock
जानवर	living being
परीक्षणकर्ताओं	Testers
33	33
ग्लेन	Glenn
मिक्सर	mixer
ग्राइंडर	grinder
जीएल4022	GL4022
मिक्सिंग	Mixing
चॉपिंग	Chopping
ग्राइंडिग	Grinding
कन्वेंसिंग	Convention
परफोरमेंस	Performance
कागज	paper
Mi4	Mi4
क्रिकेट	cricket
कौन	who
स्टेटस	status
जेड3	Z3
TDD	TDD
बैंड्स	Bands
नाकाफी	Unsatisfying
एक्टिविटी	Activity
मूव	Move
एक्सर्साइज	Exercise
दिनचर्या	daily routine
चलें	Go
बैठे	Sitting
वर्कआउट	Workout
कैसा	what like ?
सूझ	foresight
बूझ	understanding
रोचकता	interest
उठना	to rise
शुरु	Start
जख्म	injury
तक्षक	wood or stone cutter
अपहरण	kidnapping
भगत	devotee
कमर्शियल	commercial
हीरो	Hero
दर्द	pain
बयान	law deposition
झंुझलाहट	Annoyance
प्रतिष्ठा	prestige
बढ़ाने	Increase
लिखे	Written
चरित्र	character
सम्पूर्ण	full
स्टैण्डर्ड	Standard
पौधों	Plants
उपाय	means
जाएँ	Go
बागानों	Gardens
आएँ	Come
विवान	Vivan
ऐंड्रॉयड	Android
स्टार2	Star2
स्नैपड्रेगन	Snapdragon
801	801
बच्चे	children
2-जी	2-G
3-जी	3-G
फ़िट	Fit
चुक	vinegar
जेबीएल	JBL
स्‍पीकर	Speaker
थियेटर	theater
मल्‍टीपल	Multiple
पैर	foot
जरा	old age
दबाव	pressure
चर्र	Chara
पी6220	P6220
चचेरे	Cousin
भाई	Brother
पर्ल	Pearl
रैटिना	Retina
फोर्स	Force
ट्रैकपैड	Trackpad
हाईटेक	Hi-tech
रखनी	concubine
रिज़ोल्यूशन	Resolution
मछली	fish
आईडी	Id
क्रेट	crate
भींड़	Bhind
उमड़ती	Rush
ब्रह्मा	Brahma
प्रथम	first
यज्ञ	Sacrifice with a philanthropic motive
अनगिनत	countless
व्ह्यूवींग	Viewing
लुप्तप्राय	obsolescent
एशियाटिक	Asiatic
बियर	beer
स्नो	Snow
लैपर्ड	Lapard
ब्राउन	brown
शीप	Sheep
एप्स‍	Apps
डॉक्सक	Docs
माइग्रेट	Migrate
वॉकमैन	Walkman
इन्हैंसिंग	Enhancement
र्इयरफोन्स	Earphones
प्रोफाइल्स	Profiles
रिजोल्यूशन960	Resolution960
कुकर	cooker
वार्म	Warm
महावीर	great warrior
प्रवचन	sermon
विपुलागिरि	Vipulagiri
प्रारंभ	beginning
श्रम	labour
अटा	thatched upper room
हैंग	Hang
क्यूआई	QI
हिलते	Moving
सिर	head
दुखा	Sad
बोमन	Bowman
पारसी	Parsi
डीडीआर3	DDR3
बॉलीवुड	Bollywood
प्यार	love
वहा	There
डोंगल	Dongle
प्रतिदिन	every day
2200	2200
बाधा	hindrance
एस्फाल्ट	Asphalt
इंजस्टिस	Injustice
गोड्स	Sweets
अमंग	Amang
अस	Us
रूकावट	Interruption
उत्पन्न	born
लगाय	Put it on
जैक्सन	Jackson
प्रशंसकों	Fans
मनभंजक	Mind-blowing
दीपक	kindling
डोबरियाल	Dobriyal
मो.	Mo.
जीशान	Zeeshan
अय्यूब	Job
जिमी	Jimmy
शेरगिल	Shergill
एजाज	Ejaz
स्व्रा	Swra
भास्कर	sun
एटीट्यूड	Attitude
ताना	warp
बाना	dress
बुनाई	The act of weaving or knitting
स्पेशिफिकेशन	Specification
कैपेसिटिव	Capacitive
मल्टीटच	Multitouch
विश्वव्यापी	worldwide
घेरे	Circles
रोटीयां	Bread
असल	real
रोबोट	robot
महिलाओं	Women
झंझट	annoying situation
मुक्ति	liberation
दिलाने	Unleash
असफल	unsuccessful
नॉइस	Noise
तस्वीरो	Pictures
ग्रेननेस	Grain
ड्रीमवर्क्स	DreamWorks
एनिमेटेड	Animated
सेलीब्रेटिज	Celebrities
लाॅक	Lock
फैन	Fan
ए-इश्क	E-Ishq
लोकेशंस	Locations
पीटते	Beating
विवेक	discretion
परिप्रेक्ष्य	perspective
तत्व	element
एकमात्र	only one
ट्रैफिक	traffic
हॉर्न	horn
सुनाई	hearing
घडियों	Watches
दिखना	to be seen
प्लग	Plug
पाएंगे	Will find
डॉली	Dolly
डोली	small sedan or palanquin
विज़	Vis
16ज़ीबी	16GB
मुस्कान	smile
स्टीरियो	stereo
आरडीएस	RDS
एंडरॉयड	Android
संयोग	coincidence
आइकोन्स	Icons
बदसूरत	ill looking
वर्षो	Years
ठहरे	Stayed
आनन्दपूर्ण	merry
जिसक	Which
प्रतिक्रिया	reaction
फीचरों	Features
प्राइम	Prime
ड्युल	Dual
480x854	480x854
शैक्षणिक	pedagogical
सामग्री	materials
Philips	Philips
375	375
आवास	abode
रॉक	rock
इले​क्ट्रॉनिक	electronic
390	390
गिनेचुने	Count
प्राचीन	old
लिंगम	Lingam
मानवरूपी	anthropomorphic
मूर्ति	idol
प्रतिष्ठित	esteemed
निकाला	The act of turning out
सकनेवाला	The one who can
रबरयुक्त	Rubberized
पकडने	Catch
इकोसिस्टम	Ecosystem
चुनने	Choose
प्रोजेक्टर	projector
स्पर्धा	envy
गुरमीत	Gurmeet
चौधरी	Headman of a caste or trade or village
सीन्स	Scenes
ट्रकलोड्स	Truckloads
रणथंभौर	Ranthambore
अभ्यारणय	Sanctuary
परिक्षेत्र	zone
एम	A measure equal to 1/6 inch
बॉटम	Bottom
बढ़ाने	Increase
दिखेंगे	Will be seen
ताशी	Tashi
विउ	Viu
Tashi	Tashi
View	View
Point	Point
उत्तरी	northern
सिक्किम	Sikkim
North	North
Sikkim	Sikkim
Highway	Highway
राह	way
पकड़ी	Caught
मनःस्थिति	mood
यानि	I.e.
ह्यूमर	Humor
क्यूँ	why
T	T
मैट्रिक्स	matrix
चलेंगी	Play
काजीरंगा	Kaziranga
वरन	Otherwise,
सींग	horn
राइनोसेरोस	Rhinoceros
यूनीकोर्निस	Unicornis
990	990
असेम्बल्ड	Assembled
सामान	necessarie
मेकर्स	Makers
सके	Can
उठाने	Take
नॉर्मल	normal
पोर्ट्रेट	Portrait
होमस्क्रीन	Homescreen
आईकन	Icon
उठे	Get up
निकल	start
टन	ton
टॅग	Tags
क्स्पेरिया	Ksperia
जेड2	Z2
एस5	S5
एम8	M8
श्रेष्ठ	best
ट्रैकिंग	Tracking
पारा	quicksilver
ग्लाइडिंग	Gliding
रोप	seeding
क्लाइबिंग	Climbing
बोटिंग	Boating
हाइकिंग	Hiking
एक्टर्नल	External
पिछड़ता	Lagging behind
गंभीरता	depth
दूसरों	Others
गीतकारों	Lyricists
वर्मा	A class of Kayasth Hindu
मुंतजिर	Muntazir
लूक्स	Looks
सुगठित	well organized
कस्तूरी	musk
मृग	deer
तेंदुए	Leopard
थार	Thar
शास्त्रीय	classical
वोकल	Vocal
संभवत	perhaps
वार्मर	Warmer
एफ/1.8	F/1.8
अपार्चर	Aperture
लेंस	len
Goggle	Goggle
Drive	Drive
application	Applications
एप्पीलेकशन	Application
स्प्रेडशीट	Spreadsheet
संपादन	editing
दायें	Right
शटर	shutter
खरीदारी	buy
पी620	P620
एसडीएचसी	SDHC
64जीबी	64GB
शॉट्स	Shots
सिंथेटिक	Synthetic
क्रियाकलापों	Activities
एमबीपीएस	Mbps
499	499
31097	31097
ग्राहक	customer
गुस्सा	anger
दिला	Given
Urbane	Urbane
P	P
OLED	OLED
राउंड	Rounds
आईस	Ice
ड्राइवरों	Drivers
रु.	Face.
995	995
107	107
नालंदा	Nalanda
19	19
धर्मो	Religions
डिश	dish
मिलाग्रो	Milagro
माई	mother
एजू	Eju
बीएसएनएल	BSNL
पेंटा	Penta
Milagrow	Milgrow
Top	Top
HCL	HCL
My	My
Edu	Edu
tab	Then
BSNL	BSNL
Penta	Penta
टीईडी	TED
संगठन	organization
जुडी	Judy
ज्ञानवर्धक	informative
प्रेरणादायक	inspirational
विडियोज़	Videos
आज़ादी	freedom
सुंदररानी	Sundarrani
गली	lane
जसर्कोते	Jassarkote
सनासार	Sanasar
रोमांचक	horripilating
ढर्रे	Dharre
फ़ोन्स	Phones
समझौता	non-aggression pact
पिक्स़ल	Pixels
स्काइप	Skype
पोगो	Pogo
पूछ	enquiry
बलूत	oak
वृक्षों	Trees
आकषर्क	Attractive
एल4022	L4022
फिलिप्स	Phillips
32.6	32.6
सुंदरबन	Sundarbans
तीर्थराज	chief place of pilgrimage
पुष्कर	pond
प्रतिवर्ष	per annum
मेला	fair
लगेगी	Will it take
IP67	IP67
सर्टिफिकेशन	Certification
खतरा	danger
10.4	10.4
मिलीमीटर	millimetre
अनुराग	love
कश्यप	Kashyap
अलहदा	separate
मेगापपिक्‍सल	Megapixels
दुर्लभ	scarce
साइबेरियन	Siberian
क्रेन	crane
सर्दियों	Winter
WXGA1280x800	WXGA1280x800
तीखापन	sharpness
शॉर्टकट	shortcut
पूंजी	finance
दुकान	shop
सजाते	Decorate
बतौर	as
तारीफ	admiration
इकट्ठे	together
शिथिलता	languor
वैम्मी	Vammi
नियो	Neo
गीगा	Ghz
हर्ट्ज	Hz
एमटीके6592	MTK6592
माली-450	Mali - 450
4.2.2	4.2.2
स्नेपडील	Snapdeal
आस्कमी	Askami
पेटीएम	Paytm
क्विकर	Quikr
इंस्टॉल्ड	Installed
549	549
34,400	34,400
1,099	1,099
68,800	68,800
चेहरों	Faces
बजाए	Instead
दर्शाए	Shown
इंटरचेंजेबल	Interchangeable
मॉडलों	Models
एक्‍ट्रा	Extra
सातवां	seventh
अजीब	wonderful
राय	opinion
कोची	Kochi
ऍप्स	Apps
योटाफोन	Yotaphone
6,999	6,999
परगेम्स	Paragames
शैलियों	Styles
स्वस्थ	hale
रकते	
एलिफेंटा	Elephanta
तट	shore
119	119
विभु	omnipresent
पुरी	city
हवाईजादा	Hawaii
पूछने	Ask
पोर्टेबल	Portable
7900	7900
बिक	Sold
5900	5900
जिनके	Whom
मायने	Sense
तानाबाना	Tanabana
बुना	Woven
7.2	7.2
लड़ाईयां	Battles
रामसेवक	Ramsevak
अशोक	sorrowless
बांठिया	Banthia
नोटिस	notice
एलएएन	LAN
चमड़े	Leather
रीबॉक	Reebok
चश्मे	Glasses
विक्रेता	seller
प्रभावी	dominant
9000	9000
फ्लो	Flow
अर्जुंन	Arjuna
दाढ़ी	beard
चिपकाई	Pasted
1440	1440
2560	2560
किले	Fort
देवताओं	Gods
पड़े	Lying down
राइटर	Writer
रिकॉर्डिस्ट	Recordist
कोरियोग्राफर	Choreographer
उसें	He
फरवरी	February
घोड़ा	horse
एसोशियसन	Association
आर्ट	art
फेस्टीवल	Festival
आर.	Enmity.
बाल्की	Balki
156	156
हाउसबोर्ट	Housebort
ताड़	toddy tree
सरकुलर	Circular
सोचा	Thought
नयनाभिराम	pleasing to the eye
सो	go to sleep
रिजर्व	reserve
ऑप्टिमाइजेशन	Optimization
कॉम्पेटिबिलिटी	Compatibility
1020	1020
अंततः	finally
ऋतु	winter
मोहने	Mohne
सिरे	End
रचती	Creation
कैसे	How come
खिंचता	Pull
ऑपरेशनल	Operational
अट्रैक्टिव	Attractive
रोमांचित	titillated
आकाश	sky
वी	V
जयप्रभा	Jayaprabha
फेवरेट	Favourite
कॉमिक्स	Comics
दुख	suffering
कनेक्टविटी	Connectivity
बदमाशियां	Bullies
अपरिपक्व	unripe
हास्यापद	Funny
पीटने	Banging
लाइटें	Lights
लेजर	ledger
प्रोजेक्‍टर	Projector
अवेलेबन	Available,
दीवार	wall
टेबल	table
प्रोजेक्‍ट	Project
आर्म	Arm
मेगाबाइट	megabyte
डीडी	Dd
आर	enmity
रिस्पांसिव	Responsive
सिलेक्ट	Select
मैक	Mac
स्पेशलिस्ट	Specialist
सीरीयस	Serious
एडिटर	Editor
गीगाहर्टज़	Gigahertz
डालती	Exert
होली	bonfire
गुलरेज	Gulrez
लब्जों	Words
भीड़	crowd
नजरअंदाज	Ignore
हार्टरेट	Heart rate
अवेलेबल	Available
जी40/जी50	G40/G50
गीगालैन	Gigalane
डीवीडी	DVD
ठाकुर	deity
अनुकूलचंद्र	Anukul Chandra
अपस्केल	Upscale
कास्ट	Cast
भारतीया	Indian
ब्रश	Brush
फिनिशिंग	Finishing
स्टीकर	sticker
नवाज	Nawaz
364	364
मल्टिटास्किंग	Multitasking
आईफ्लोट	iFloat
अथावा	Athwa
प्रॉसेसिंग	Processing
बढ़ोतरी	increase
घातक	fatal
बचत	saving
मानना	to agree
इकलौता	single
दारा	wife
किक	kick
स्कैंडल्स	Scandals
मेकिंग	Making
जुड़े	Associated
किस्से	From what
सोना	gold
ओब्सीडियन	Obsidian
स्टोन	stone
सिरेमिक	Ceramic
अलॉय	Alloy
झंकारयुक्त	Flagged
250	250
4आइ	4I
10.68	10.68
एप्लिकेशन्स	Applications
आँखमिचौनी	Hide and seek children’s game
नुबिया	Nubia
471	471
थिएटर	theater
मामा	maternal uncle
मां	mother
रवि	the sun
झांकल	Glimpses
नवल	new
ताजगी	freshness
हनीमून	honeymoon
डिस्टनेशन	Distension
चारो	All four
तगड़ा	strong
3080	3080
milli	Milli
Ampere	Ampere
hour	Hours
19,999	19,999
एस्युस	Asus
वियाओ	Viao
चौथी	fourth day
जनरेशन	Generation
टीएम	Tm
आई5	I5
सेलेरोन	Celeron
भागीदार	partner
बैठकर	Sit
जानवरों	Animals
सीखना	To learn
जोड़ते	Add
हरदिन	Every day
लेयर्स	Layers
व्यक्तिगत	individual
आये	Came
कम्पनी	company
261	261
आउडिया	Odia
टीप	sketch
सब्सक्रिप्शन	Subscription
20-22	20-22
16-17	16-17
बताते	Show
zenwatch	ZenWatch
वियरेबल	Wearable
गैजेट	gadget
है,2.5	Is 2.5
डायमीटर	Diameter
जेनवॉच	GenWatch
जैकब	Jacob
मारी	epidemic
असुविधा	inconvenience
लीथियम	lithium
आईऑन	iOn
कोइ	Someone
टोग्गल	Toggal
बदलने	Change
एक्‍सनॉस	Exxons
ऑक्‍टा	Octa
चाह	desire
32GB	32GB
प्रतिभाओं	Talent
फिजूलखर्ची	Wasteful expenditure
अंगुली	finger
होमपैज	Homepage
डाल	branch
अनस्टॉल	Uninstalled
खींचकर	By dragging
साइंस	science
लेआउट	Layout
पिग्मी	pygmy
हॉग	Hog
साप्ताहिक	weekly
जगन्नाथ	Jagannath
नारायणी	an epithet of Lakshmi
रिज्यूम	Resume
नमन	bowing
सुनिश्चित	definite
महेन्द्र	Mahendra
मेवाती	Of or belonging to Mewat in Haryana
असरदार	Effective
वेयर	Ware
बाहरी	outward
खोल	cavity
चेसीज़	Chassis:
पोलीकार्बोनेट	Polycarbonate
सुधारा	Repaired
ताजा	fresh
डीप	Deep
फिशिंग	Phishing
कैसी	how
शाहरुख	Shah Rukh
पहचानी	Recognized
अदाएं	Payments
सत्संग	association with good people
तीर्थस्थलों	Places of pilgrimage
गंगटोक	Gangtok
पूर्वी	eastern
हिमाच्छादित	snowy
पहाड़ियों	Hills
गुजरती	Pass
रिकार्ड	record in writing
स्कैनर	scanner
चैनलों	Channels
ब	The twenty-third consonant of the Devanagari syllabary
स्कैनिंग	Scanning
820	820
ऑनबोर्ड	Onboard
माह	the moon
डिमांड	demand
सेक्शन	section
सौदा	frenzy
5.7	5.7
लोकप्रियता	popularity
मांग	demand
बिक्री	sale
बर्फबारी	Snowfall
क्रिस्प	Crisp
प्रोफेशनल्स	Professionals
फॉलोअर्स	Followers
क्वर्टी	Qwerty
कृति	act
डाउनलोडर	Downloader
फूजी	Fuji
फिल्‍म	Film
फूजीफिल्‍म	Fujifilm
X20	X20
X100S	X100S
16.3	16.3
एपीएस	Aps
सिराज	lamp
चेश्मशाही	Cheshmashahi
इंदिरा	goddess of wealth
गांधी	perfume seller
मेमोरियल	memorial
अन्यथा	otherwise
Millagrow	Millagrow
tablet	Tablet
tablets	Tablets
सैंगमेंट	Segment
अगला	foremost
शुक्र	the planet Venus
आसनी	a small carpet
मोनिटर	Monitor
ऑपरेट	Operate
Rs	Rs
15,799	15,799
करी	elephant
स्पोर्टिंग	Sporting
कॉन्ट्रास्ट	Contrast
धुप	Sunshine
अच्छ	clear
दीखता	Looks like
4जी/3जी	4G/3G
एक्सटर्नल	External
कॉम्पैटिबल	Compatible
जयदेव	Jayadev
अधूरे	Incomplete
रचे	Composed
बेज़ल	Bezel
तिरछी	Oblique
धार	Sharp edge of a sword or such other weapon or instrument
पृष्ठ	back
वक्र	crooked
ऑटोमोबाइल	Automobile
रिडक्शन	Reduction
पविलियन	Pavilion
जी6-2227टीयू	G6-2227TU
जोड़ते	Add
फाइलें	Files
कलचर्ल	Culture
सेंटर	centre
संग्राहलय	Museum
गीगार्हट	Gigarhat
कार्टेक्‍स	Cortex
प्रोससर	Processor
स्‍टोरज	Storage
केमरा	Camera
कीमत-13,700	Price - 13,700
प्रोजेक्ट	Project
बटर	Butter
मिलिमीटर	millimetre
140	140
गर्दन	neck
शर्ट	Shirt
रिसेप्शन	Reception
दिलचस्पी	interest
फिल्मिस्तान	Filmistan
बैकस्पेस	Backspace
छेड़	teasing
छाड़	Rod
अरुणाचल	Arunachal
समुद्री	of the sea
5754	5754
1,780	1,780
जिरो	Zero
सांस्कृसतिक	Cultural
गैलापगोस	Galápagos
अज्ञात	unknown
संयुक्त	united
राष्ट्र	nation
स्पेशल	special
7.4	7.4
टैबलेट्	Tablet
हनी	Honey
त्रेहन	Trehan
खोजे	Found
च्योर्तिलिंग	Chartling
लंकापति	Lankapati
रावण	Ravana
एनिमेशन	Animations
नोट्स	Notes
प्लानर	Planner
क्रेयान	Crayon
फिजिक्स	Physics
फोटोशॉप	Photoshop
सेटिंग्स	Settings
कांफ्रेस	Conference
कनेक्‍ट	Connect
480	480
लॉन्चेस	Launches
लॉन्ग	Long
टर्म	Term
स्‍क्रॉल	Scroll
नॉब	Knob
चूकते	Mistakes
कटी	Chopped
द्वेष	ill-will
प्रतिशोध	revenge
आत्मसात	assimilation
खेतो	Farm
हैन्डलूम	Handloom
जीवनयापन	Passing or spending ones life
20.8	20.8
टॉक	Talk
स्‍टैंडबॉय	Standboy
बाधित	compelled
सुविधाएं	facilities
बाएं	Left
9600	9600
नवविवाहित	newlywed
जोडे़	Couple
टॉय	Toy
डेढ़	one and a half
तरफ़	side
दर्शनीय	worth seeing
कलाकृतियां	Artefacts
फारसी	persian
यूरोपीय	European
मिश्रण	mixing
जिसको	to whom
शाहजहांनी	Shahjahan
ध्रुव	firm
हाइब्रिड	Hybrid
ड्राइवर्स	Drivers
स्नेपर	Snepper
नैचरल	Natural
सिचुएशन	Situation
वॉ	Waugh
यस	Yes
2499	2499
युवान	Yuvan
कल्कि	The tenth incarnation of Vishnu yet to appear
निपटान	accomplishment
​​कि	that
खड़ा	standing
वाईट	Bad
बॅलेंस	Balance
रिप्रॉडक्शन	Reproduction
मुद्रा	seal
आमदनी	income
जरिया	Way
विभाग	apportionment
सकेंगी	Can be able
विक्रमजीत	Vikramjeet
आएंगी	Will come
बीट	droppings of bird
कंट्रोल्स	Controls
डायल्स	Dials
उलझन	complication
गोल्ड	Gold
लगनेवाला	Looks like
वास्तुशिल्प	architecture
ख़ूबसूरती	beauty
नसीरूद्दीन	Naseeruddin
नील	blue
145	145
वजनी	Weighing
3140	3140
ज़रासी	A little bit
ढाँचेवाले	Structure
जिसने	Who
पद्धति	custom
अपनाया	Adopted
Wall	Wall
Mount	Mount
जगमगाती	Sparkling
बिरंगी	Colorful
लॉगिटेक	Logitech
अल्टिमेट	Ultimate
ईयर्स	Years
ब्रांडेड	Branded
बेचने	Sell
स्पेक्ट्रम	spectrum
संभालता	Handles
रितुपर्णो	Rituparno
सत्यान्वेषी	Truthful
मे	In
सुजॉय	Sujoy
रेटिना	retina
हिलता	Budge
दर्जे	Grade
ब्राउज़र	browser
फ़ास्ट	Fast
परफोर्मेस	Performance
जेड3735डी	Z3735D
1.83	1.83
दबाते	Press
गुंजाइश	space
बाला	an ear-ornament
गिरते	Falling
प्रवाह	flow
मंत्रमुग्ध	spellbound
मानों	Values
जन्नत	heaven
विचरण	wandering
आश्चर्य	wonder
उन्मुक्तता	abandon
सैरगाह	Place for walking or excursion
बनने	Become
चलाएगी	Will run
सबको	Everyone
उतनली	
जितनी	As
बजे	o'clock
नौ	the figure nine
तपोवन	Forest where ascetics perform austeritie
शिवमंदिर	Shiva Temple
बैकड्रॉप	Backdrop
गॉसिप	Gossip
ठप्पे	Labels
छपाई	printing
कपड़ा	cloth
बंधेज	restriction
कढ़ाई	embroidery
वस्त्रों	Fabrics
कच्छी	Of or belonging to a marshy place q.v.
उभार	swelling
घूमाव	Walking around
र्इएम1	EM1
खोजने	Find
र्इयर्स	Years
चुकानी	Pay
संस्थापक	founder
दवाब	Pressure
परे	beyond
क्रिएटिव	Creative
कट्टरता	orthodoxy
मिनिमाइज़	Minimize
कॉन्फ्रेंसिंग	Conferencing
स्टैंडर्ड	Standard
स्वाइप्स	Swipes
एक्सेस	Access
कार्यशैली	Working style
इंटर्नल	Internal
मोइक्रोमैक्स	Micromax
कंपनियों	Companies
श्योक	Shyok
नुब्रा	Nubra
साइकिल	bicycle
बाइक	bike
अभियान	campaign
दादी	Grandmother
प्रौढ़	mature
एलबम	album
रेस्टोर	Restore
लॉग	log
आर्इडी	I.D.
गड़बड़ी	commotion
फॉर्मैट	Format
720p	720p
संकेत	sign
ग्रहण	acceptance
ऑडियोफाइल	Audiophile
कलेक्टेबल	Collectorable
तीक्ष्ण	sharp
तारीख	date
कंपनियां	Companies
वेव	Wave
चौड़ाई	breadth
अनदेखा	unseen
MAd	MAd
कागजी	paper
आंकड़ों	Data
साला	Brother in Law
फेवरिट	Favorite
दिखायी	Shown
आयुर्वेद	Ancient Indian treatise on medical science
चिकित्सीय	Of or relating to science of medicine
काफ़ी	enough
रूम	room
सराउंड	Surround
लाइनिंग	Lining
श्रेय	credit
किस	what
उल्लेख	mention
डिज़ाईन	Design
एल्यूमिनियम	Aluminum
कंस्ट्रक्शन	Constructions
नाग	cobra
कोबरा	cobra
अमरनाथ	Amarnath
बाहु	arm
कुद	Jump
गढ़	fort
रिसेट	Reset
चीनी	Chinese
रिस्टोर	Restore
हकीकत	Reality
कहां	where
512एमबी	512MB
S5	S5
घेरा	enclosure
बारंबार	again and again
दत्ता	given away in marriage
प्रतिमा	idol
कण्णन	Kannan
यामी	Yami
लेश	trace
v3000	v3000
64-बीट	64-beat
SoCs	SoCs
ध्येय	goal
नेतृत्व	leadership
प्रहसन	comedy
डीटीएच	Dth
सब्सक्राइव	Subscribe
परीक्षणों	Tests
ऑल	All
सुनहरे	Golden
दुर्गम	inaccessible
दहेज	dowry
उठाती	Raises
498ए	498A
शास्त्र	code of law
मूर्तियां	Sculptures
क्यू3000	Q3000
आक्रमण	attack
क्रूरता	cruelty
मसालों	Spices
बची	Survivors
खुची	Khuchi
मिस्क	Misk
जी2	G2
G2	G2
पहन	Wear
दोहरा	double
सक्रीन	Screen
छुट्टियां	Holidays
बिताने	Spend
फौना	Fauna
रिमूवेबल	Removable
व्याख्याएं	Explanations
बलूगा	Baluga
बेड	Beds
मनचाही	Desired
नींद	sleep
संगति	company
बिठा	Sit down
विचित्रता	strangene
मौलिकता	originality
सहेज	Save
संबंधों	Relationships
झाड़ा	excreta
पोंछा	duster
ग्लो	Glow
स्विंग	swing
टयूर	Tür
सीसीटीवी	Cctv
पंकज	Anything produced in slush especially lotu
नसीरुद्दीन	Naseeruddin
परफारमेंस	Performance
चकित	surprised
मल्टीमिडिया	Multimedia
दोहरे	Double
2.8	2.8
जखीरा	Stockpile
समाधान	solution
सामर्थ्य	valence
कम्पेटिबल	Compatible
बैंडविथ	Bandwidth
settings	Settings
हालाकि	However
इंकजेट	Inkjet
ईबुक	eBook
दिक्कते	Problems
वर्षा	rain
बादलों	Clouds
विपरीत	opposite
लैपटैब	Laptops
बर्तन	vessel
rm	.rm
flv	.flv
mov	.mov
avi	.avi
mkv	MKV
ts	ts
mp4	.mp4
खाई	ditch
गंभीर	deep
HP	HP
12.5	12.5
वीटाकंट्रोल	Vitacontrol
अभिनेताओं	Actors
गाढ़ा	of cloth
स्टैंडबाय	standby
पुष्ट	fat
आइटम	item
सॉन्ग	Song
चिप्पी	small patch
15.6-इंच	15.6-inch
हमलों	Attacks
10-11-इंच	10-11-inch
व्युविंग	Viewing
वांटेड	Wanted
टोक	interruption
नवदीप	Navdeep
अनुष्का	Anushka
एनएच	Nh
कैंची	scissor
फंक्शन	Function
शिवकर	Shivkar
तलपड़े	Talpade
खड़े	Stand
कागजों	Paper
चलिए	Let's
जांचते	Check
असलियत	reality
28	28
तलाश	search
लागत	cost
न्यूनतम	minimum
दिखनेवाली	Visible
तस्वीरे	Photos
एनालॉग	analog
रिसीवर	receiver
मनपसंदीदा	Favorite
फिंगरटिप	Fingertip
गेमलॉफ्ट	Gameloft
जीटी	Gt
यूयूनिवर्स	Uuniverse
वॉल	Wall
शहरी	citizen
हलके	Light
थोडी	A little
ब्राउज़िंग	Browsing
170	170
वी4.1-	v4.1-
वीनस	Venus
माईर	Myr
सप्रेशन	Suppression
मैक्स	Max
आईएसओ25600	ISO25600
4के30पी/25/24पी	4K30P/25/24P
60पी/50पी/24पी	60p/50p/24p
10बिट	10bit
वीएफआर	VFR
गीगहर्त्ज	GHz
अकबर	Akbar the great Mughal emperor
1583	1583
ईसवी	A.d.
सावधान	careful
सरफराज	Sarfaraz
राजपूत	A martial race of Hindu
इरफान	Irfan
लीं	Lin
ग्राफ़िक	Graphic
संरचनात्मक	structural
भाएगी	Run away
बिजली	lightning
गृद्धकूट	Grim
कैंपेन	Campaign
धोतीधारी	Dhotidhari
सुरक्षाकर्मी	Security personnel
भागलपु	Bhagalpu
मुंगेर	Munger
संवेदशीलता	Sensitivity
Curved	Curved
Edges	Edges
फिसलता	Slipping
FHD	FHD
रेसोलुशन	Resolution
8.9	8.9
किकस्टैंड	Kickstand
भूरा	brown
संक्षिप्त	concise
बुनी	Knitted
साइनोजेन	Cyanogen
ढला	Cast
इनकॉरपोरेट	Incorporated:
तैरने	Swim
मोहिनी	fairy
लहजा	tone
सृजन	production
जबरन	Forcibly
हंसाने	Laugh
वसंत	the spring season
खिल	develop
क्लाउड	Cloud
ड्रॉप	Drop
फ्रूट	Fruit
निंजा	ninja
एग्री	Agri
प्लाई	Ply
अतः	therefore
विजुअल	Visual
थम	stop
आनंदित	pleased
दिखा	show
1889	1889
उपरोक्त	above-mentioned
आर्चवे	Archway
घड़ियां	Clocks
लगाई	love
160	160
हल्‍का	Light
सच्चार्इ	The truth
पायेगा	Will get
प्रारंभिक	initial
अनजान	unknown
बेज़ेल	Bezel
जार	paramour
ऑयल	Oil
सील्स	Seals
चूर्ण	powder
चौड़ी	Wide
पत्ती	small leaf
नुकीली	Sharp
पेड़ो	Trees
लुभाते	Tempting
शूरू	Start
नैनीताल	Nainital
कार्बेट	Corbett
वन्यजीवों	Wildlife
वनस्पतियों	Flora
फुल्का	round
मुक़ाबले	Competition
एंटोनियो	Antonio
आईवाच	Mother's
2-6	2-6
सैकेंड	Second
कपल	Couple
गोंबर	Gomber
गुजराती	Gujarati
एसेंट	Assent
सख्त	strict
रिस्पाँस	Response
हिंसा	violence
अनगढ़	unfashioned
कमजोरियों	Weaknesses
ग्लेयर	Glacier
प्रॉब्लम	Problem
सोते	Sleep
हिन्दी	Hindi
प्लेस्टेशन	PlayStation
तीर्थयात्रियों	Pilgrims
तांता	Tanta
घटनाएं	Phenomena
घटती	decrease
युक्त	combined
अमीर	rich
हरियाणवी	Haryanvi
ठस	of cloth thickly woven
आम्र्ड	Armd
फोर्सेज	Forces
एक्ट	Act
लागू	applicable
दमन	suppression
बेकाबू	uncontrollable
कॉवन	Cowan
र्इएच2	EH2
25k	25k
हेडफोन्स	Headphones
8k	8k
पेडनेकर	Pednekar
कीसी	Someone.
चलाए	Run
सिक्योर	Secure
एंक्रिप्शन	Encryption
दूने	multiplied by two
9.9	9.9
इंसान	human being
पैदाइशी	inborn
एमओवी	MoV
क्‍लासी	Classy
माप	measure
144.8	144.8
72.8	72.8
10.2	10.2
कभीर	Sometimes
फोटोग्राफ	photograph
ऍक्वा	Aqua
हॉर्सेस	Horses
1989	1989
परिंदा	bird
रीमेक	Remake
इजाफ़ा	Increase
स्लटर	Slater
टचविज़	TouchWiz
10,199	10,199
एमोल्‍ड	Amold
768,000	768,000
फि्लपअप	Flappup
ग्‍लेयर	Glacier
लिड	Lid
जीवजन्तुओं	Animals
फैसला	decision
7वीं	7th
16वीं	16th
शताब्दी	century
फीचर्ड	Featured
टॉक्स”	Talks"
महत्ता	greatne
दिनांक	date
महता	Mahata
डेट	date
परत	layer
स्‍टैंनलेस	Stainless
स्‍टील	Steel
Bluetooth	Bluetooth
वर्गाकार	square
डिजाजस्टर	Disaster
पहनी	Wore
चीप	Chip
बगी	Rebel
ब्लिट्ज़	Blitz
87	87
81	81
9.1	9.1
स्क्रैच	Scratch
पकड़	grasp
टाइटेनियम	titanium
ओक्टेन	Octane
2,000	2,000
ड़ाली	Cast
भीतर	inside
मिलाते	Shaking
दोगुना	double
उन्हीं	Same
2100	2100
Fit	Fit
टूर	tour
एसोसिएशन	association
कोशिशें	Attempts
एयरपोर्ट	airport
उतरकर	Get down
बिगड़ता	Worsening
सेलफोन	Cellphone
दूसरो	Others
रजिस्ट्रेशन	Registration
जुड़ी	Associated
सेल्युलर	Cellular
सेवादाता	Service providers
प्रचार	propaganda
प्रसार	expansion
नेवीगेशन	Navigation
पाएगा	Will find
कमजोरी	lethargy
सर्किट	circuit
VGA	VGA
यहूदी	Hebrew
मुसलमान	Muslim
4000mAh	4000mAh
सच्चाई	Truth
फाइन	fine
ट्यून	Tune
कन्संप्शन	Concept
जॉम्बी	Zombie
ग्लैमरस	Glamorous
वैंपायर	Vampire
समयांतराल	Time interval
विलंबित	delayed
ह्वाइट	White
बैलेन्स	Balance
ओलियोफोबिक	Oleophobic
फिंगर	Finger
बचाता	Saves
एम1	M1
किमी.	Km.
टनल	Tunnel
युद्धस्तर	War level
अौर	More
आइकोनिया	Iconia
TFT	TFT
149	149
ppi	PPI
350	350
निट्स	NITS
चौथा	fourth
वर्ज़न	Version
बादशाहत	kingdom
बरक़रार	Intact
सानासर	Sanasar
रोड	road
माधाटॉप	Madhatop
स्कीइंग	skiing
रैम,512जीबी	RAM, 512GB
हार्डडिस्क	Hard Disk
5वाइ10	5Y10
68	68
मेनु	Menu
खारदुंग	Khardung
लेह	Leh
कशगर	Kashgar
बदलापुर	Badlapur
ज्यू2	JU2
क्वालिटी-720पी	Quality-720P
क्‍वाडकोर	Quadcore
क्‍वालकम	Qualcomm
जीएसएम	GSM
सीडीएमएस	CDMS
नेवर्क	Network
विशेषकर	particularly
लाइक	Like
मिस्ट्री	Mystery
अप्रासंगिक	irrelevant
बचकाना	childish
साईड	Side
लेबल	label
स्पार्टन	Spartan
एक्सप्लोरर	Explorer
लगवाना	To cause to be attached
गंदे	Dirty
दिखावट	ostentation
खरोंच	scraping
ख़ुशी	joy
मक्का	maize
अंदरूनी	internal
अग्रणी	foreman
Microsoft	Microsoft
विधिवत	Duly
आधिकारिक	authoritative
आउटलुक	Outlook
वीडियोकॉन	Videocon
VT75C	VT75C
जैलीबीन	Jellybean
2मेगापिक्‍सल	2 Megapixels
कृतिम	Kritam
रमणीक	beautiful
42,000	42,000
विपुलगिरि	Vipulgiri
रत्‍‌नागिरि	Ratnagiri
उदयगिरि	Udayagiri
स्वर्णगिरि	Swarnagiri
वैभारगिरि	Vaibhargiri
बहु	Daughter-in-law
सैफाइअर	Sapphire
कोटिंग	Coating
धुंआधार	Fog
यदा	Occasionally
कदा	Sometimes
रेकॉर्डर	Recorder
इत्यादि	So on and so forth
ज़ोलो	Zolo
LT900	LT900
मेगापिक्सल्स	Megapixels
चौथाई	one-fourth part
फोनी	Foni
शासन	rule
अंग्रेजो	The British
गर्मियों	Summer
इंजीनियरिंग	engineering
नज़दीक	close
श़ौकीन	Shokeen
शिमला	Shimla
चरम	extreme
सुख	happiness
पेंटेक्‍स	Pentex
एमएक्‍स	MX
प्‍वाइंट	Point
MX	MX
3इंच	3inch
कैपेचर	Capture
4100	4100
पॉलीमर	Polymer
7,499	7,499
कायम	Permanent
ख़ासियत	speciality
गिराई	Dropped
थक	Tired
प्रमोशनल	Promotional
फंक्शनैलिटी	Functionality
कइयों	Many
डार्क	Dark
परछाईं	reflection
नेबर	Neighbor
सायकोलॉजिकल	Psychological
थ्रिलर	Thriller
आरंभ	beginning
ऐरोटिक	Erotic
डेली	basket for keeping rice
नेटवर्क्स	Networks
ढूंढने	Find
लैला	a beloved
बोस	Bose
ग्रंथियों	Glands
कच्छ	land bordering on water
रेगिस्तान	sandy place
संवेदना	sensitivity
व्‍यक्तिगत	Personal
यूसेज	Usage
पर्वतमालाओं	Mountains
मज़बूत	strong
फौरी	Immediately
X	X
Pixels	Pixels
व्यवस्थित	systematic
लुभावनी	Breathtaking
वेबपेज	Webpage
टैक्स्ट	Text
ऑफिशियली	Officially
रजिस्टर्ड	Registered
कॉम्पिटेबल	Compatible
इंटिग्रल	Integral
डेडिकेटिड	Dedicated
एयरपीस	Airpiece
हैंड्सफ्री	Handsfree
तीस्ता	Teesta
शिखर	apex
बहती	Flows
जिद	bet
उत्कृष्ट	superior
गिलास	glass
बेल	Wood-apple tree and its fruit
फैलती	Spreads
गायब	missing
सराउंट	Surrount
झीलें	lakes
चांद	moon
स्टंट	stunt
Lag	Lag
महिला	lady
नाजुक	girlish
परंपरा	tradition
5MP	5MP
पड़ने	Falling
लाइ	Lai
पो	Po
Li	Lee
Po	Po
हेड	head
पकड़ना	to catch
केसियो	Caseio
शॉक	shock
मज़ा	pleasure
क्वाॅडकोर	Quadcore
खरोंचरोधी	Anti-scratch
देखता	seeing
स्मृति	memory
2GB	2GB
असतत	discontinuou
NVIDIA	NVIDIA
GeForce	GeForce
जी.	Yes.
टी.	Tea.
740M	740M
लिविंग	Living
शान	dignity
वाच	watch
21,500	21,500
अरूणोदय	Arunoday
काते	Thorns
प्रौद्योगिकी	technology
wedge	Wedge
ठोस	solid
फुली	A hard whitish overgrowth in the eye
परफ़ॉर्मर	Performer
धीमापन	Slowness
एक्टिीविटी	Activity
मुहैया	available
कराएगा	Provide
बटेरी	Buttery
पर्फोर्मांस	Performance
इनपुट्स	Inputs
विचारों	Views
..	..
खाली	empty
कुर्सी	chair
तलबगार	seeking
ः	:
रचा	Hatched
ए6एक्स	A6X
23,940	23,940
बारेहीपानी	Barahipani
जोरांडा	Joranda
फॉल्स	Falls
दशावतार	The ten incarnations of Lord Vishnu
ईको	Eco
सुरकंडा	Surkanda
वीवर्स	Weavers
देशभक्ति	patriotism
जोश	zeal
अंधराष्ट्रवाद	chauvinism
अंतद्र्वंद्व	Conflict
रिज़्ोल्यूशन	Resolution
960	960
कार्ल	Carl
जीस	Jesus
पिल्लसलुंकी	Pillasalunki
ट्रीगर	Trigger
डेवलपिंग	Developing
शीर्ष	the head
7इंच	7 inches
एमोल्ड	Amold
मनुष्य	man
अंगो	Organs
परिचालन	organising
दिक्कतें	Problems
6500mAh	6500mAh
0.28	0.28
आश्चर्जनक	Amazing
10.9	10.9
औंस	ounce
तुक	rhyme
सूर्योदय	sunrise
पाखो	Look at it
लोडिंग	Loading
नापसंदगी	disapproval
डेनसिटी	Density
सक्वेयर	Square
क्लियेरिटी	Clarity
पिक्सलेशन	Pixelation
प्रतिघात	counter-blow
नायकपुरुष	Hero
अनजाने	unknowingly
निकालेंगे	Will remove
जायेंगे	Will
उत्सव	festival
पार्वती	A title of Durga as daughter of Himavat
विवाह	marriage
समारोह	function
अत्याधुनिक	ultra modern
लाजवाब	unable to reply back
गुफाओं	Caves
पौराणिक	mythical
अत्यन्त	greatly
बिग	Big
पाने	Get
गंवा	Lose
स्ट्रेटजी	Strategy
समस्याओं	Problems
आदत	habit
स्पर्धक	Competitors
पी81	p81
मोटोराला	Motorola
TI	TI
OMAP	OMAP
दत्तो	Datto
रनोट	Ranot
आत्मसविश्वाास	Self-confidence
अव्यवस्थित	disordered
यूनीबॉडी	Unibody
बढ़ने	Grow
बिगफ्लिक्स	Bigflix
पावर्ड	Powered
रेजॉल्यूशन	Resolution
आया-	Nurse-
720x1280	720x1280
निकोन	Nikon
डी810	D810
डफ़ोन्स	Duffons
NFC	NFC
नियर	Near
फील्ड	Field
कम्युनिकेशन	Communication
जांबाज	Brave
अधिकारियों	Officers
Ambilights	Ambilights
एनएफसी	NFC
आनामुड़ी	Anamudi
राजमाला	Rajmala
चितीरापुरम	Chitirapuram
इकोपाइंट	Ecopoint
मट्टुपेटी	Mattupetty
स्क्रॉलिंग	Scrolling
मल्टिटास्कींग	Multitasking
2007	2007
अथवास	Athavas
डयूअल	Dual
चिंतित	perturbed
हाय	Hi
तौबा	Vow to do no more
मचाती	Machati
आर्या	Arya
अंडरसॅच्यूरेटेड	Undersaturated
कट्टे	Cut
विषयों	Topics
पिरोने	Thread
दत्तोे	Datto
अवस्थीन	Awastheon
संयोगों	Coincidences
डिफरेंट	Different
एडजस्ट	Adjusting
फोटोज	Photos
कोइचलिन	Koichlin
जयपुर	Jaipur
अंबर	a perfume
एलिफैंट	Elephant
चेन	chain
निकोस	Nikos
एंड्रिटसेकिस	Andritsekis
अनुकूल	favourable
रंगो	Colors
शेड्स	Shades
उद्योग	endeavour
आईट्यून्स	iTunes
शौंक	Shauk
रेटिंग	rating
च्वॉइस	Choice
मैग्जीन	Magazine
जोरों	Swing
29.6	29.6
खींचेगा	Will pull
अनिवार्यता	inevitability
रहनी	Stay
जिओमी	Xiaomi
साथी	companion
अभिजीत	Abhijeet
भैंसें	Buffaloes
समार्टवॉच2	Smartwatch2
पर्सेंट	percent
एंड्रोइड	Android
कम्पैटिबल	Compatible
पीढ़ी	small stool or pedestal
उच्चस्तर	High level
ओजीएस	OGS
व्यूवींग	Viewing
देवगन	Devgan
सरीखे	Like
कद्दावर	On the top
बेचारगी	helplessne
365	365
टेबराबाइट	Tebrabyte
बायोस्फियर	Biosphere
पैसों	Money
मौर्य	Maurya
गुप्त	hidden
साम्राज्य	empire
मुगल	mogul
समृद्धशाली	Rich
विवान्टे	Vivante
सुसज्जित	well decorated
पीढ़ी	small stool or pedestal
राम	omnipresent God
गीगाबाइट	Gigabyte
एक्जनॉस	Exgnos
4210	4210
वाई500	Y500
दाहिने	towards the right
मार्किंग	Marking
वगैरह	first
सिवाए	Except
डिफ़ॉल्ट	Default
ग्रामीण	rural
इलाकों	Areas
रहकर	Staying
रू	Rs
ब-रू	B-Ru
माधवन	Madhavan
स्वर	tone
वॉर्स	Wars
माने	meaning
पब्लिशर	publisher
गेमविल	Gameville
प्रॉडक्ट	Product
आसमानी	airy
एलीमेंट्स	Elements
सम्मिश्रण	blending
540x960p	540x960p
क्लैरिटी	Clarity
खिंचते	Pull
स्‍टेनलैस	Stainless
सरलता	simplicity
विशेषत्व	Speciality
रबड़	rubber
ढक्कनों	Lids
आइएसओ	Iso
ISO	.ISO
धुंधलापन	haziness
117	117
पासकोड	Passcode
जनरल	general
भटकाव	bewilderment
ऑफलाइनल	Offline
इन्सटॉल्ड	Installed
ब्राजीलियाई	Brazilians
फुटबाल	soccer
स्ट्राइकर	striker
नेमार	Neymar
समाचार	new
छाई	Shadow
2MP	2MP
नपा	Napa
तुला	a pair of scale
संयमित	disciplined
ब्युटिफिकेशन	Beautification
रिंकल	Rinkle
दाग	stain
धब्बों	Spots
रिमूव	Remove
एर्गोनॉमिकली	Ergonomically
नदारद	missing
1024X600	1024X600
कम्प्लीट	Complete
इन्सटॉल	Install
एक्सेसिबल	Accessible
भेटखोल	Meet
ब्रह्मिणी	Brahmani
होनेवाला	Going to happen
802.11b	802.11b
g/n	g/n
पेरियार	Periyar
ए1000	A1000
मास्‍टर	Master
पीस	grind
छुट	Discounts
हज़ार	one thousand
बगैर	Without
समझिए	Understand
एक्सीक्यूशन	Execution
वैसी	Like that
हारने	Losing
वारटप्रूफ	Waterproof
लेपटॉप20	Laptop20
परफार्मेस	Performance
ऊर्जा	energy
148	148
मधुर	sweet
औचकपन	Surprise
हरिद्वार	Haridwar
ऋषिकेश	Rishikesh
घाटों	Ghats
हाँ	Yes
सीढ़ियों	Stairs
चाँदनी	moonlight
Bonfire	Bonfire
भक्तों	Devotees
विदेशों	Overseas
सेवर	Saver
अंक	numerical figure
बटोरता	Gathers
दोष	defect
Ghz	Ghz
Cortex	Cortex
A8	A8
processor	Processor
Dual	Dual
Mail	Mail
operating	Operating
system	System
फैक्ट्री	Factory
पड़ती	fallow land
जन्म	birth
धैर्य	patience
परीक्षा	examination
सुस्पष्ट	vivid
इन्टरफेस	Interface
गोविंदा	Govinda
स्फूर्ति	agility
शरद	autumn
कटारिया	Kataria
बनारस	Banaras
44Whr	44Whr
वॉट	watt
ताकतवर	powerful
2G	2G
टॉकटाइम	Talk time
362	362
स्टैंडबाइ	Standby
मैसेजिंग	Messaging
ग्राइंडिंग	Grinding
चटाई	mat
कनेक्टेट	Connect
पासबुक	passbook
बंजी	Bungee
जम्पिंग	Jumping
राफ्टिंग	Rafting
क्वक	Quake
लुमिया	Lumia
4,5	4,5
चटख	Hot
कठोर	hard
नंगी	Drawn
उभारने	Rise
जताने	Asserting
4,111	4,111
न्यायिक	judicial
जूझना	to fight hard
मिररलैस	Mirrorless
डीएमसी	DMC
मिलाजुला	assorted
नेम	routine
चमकरहित	unburnished
मैटेरियल	Material
बटंस	Buttons
प्रसिद्द	Famous
मेसेजिंग	Messaging
व्हाट्सएप	WhatsApp
एकीकरण	unification
आरम्भ	start
तस्‍वीरों	Photos
जियोटैग	Geotags
दोस्‍तों	Friends,
स्ट्रिप	strip
गंवई	Earthy
अंगुलियों	Fingers
कठिन	hard
जलभरत	Flood
महात्माओं	Mahatmas
समाधि	trance
सजता	Decorating
पनघट	Place to draw water from a well
आयेगा	Will come
रिंग	ring
हालांकी	However
मद्देनज़र	In view
4.1.2	4.1.2
करवाता	Get it done
नाओ	Now
समस्‍या	Problem
अपूर्व	unprecedented
4की	4ki
फ्लेगशिप	Flagship
खाता	eating
पिछे	Back
छोड़ता	Leaves
र्इमानदारी	Honesty
वैकल्पिक	alternative
ढेर	heap
फ्लेक्सिबिलिटी	Flexibility
मद्दम	Madam
सिंधु	the river Indu
सम्मोहित	hypnotized
प्रोडेक्‍ट	Product
विश्‍व	World
एसेसीरीज	Aceseries
भविष्‍य	Future
गैजेटों	Gadgets
बलाव	Balav
जीता	alive
करिएगा	Will do it
ज्योतिर्लिगों	Jyotirlingas
रीचार्ज	Recharge
Operating	Operating
Lollipop	Lollipop
3मेगापिक्सल	3 megapixels
420	420
बहाने	Shed
भावनाओं	Emotions
परतदार	layered
1600	1600
फैली	Extends
कन्याकुमारी	Kanyakumari
थोड़	A little
लदा	Laden
गाइरो	Gyro
ग्रैविटी	Gravity
Gyro	Gyro
sensor	Sensors
gravity	Gravity
नियम	rule
गो	cow
पॉली	Poly
कार्बोनेट	Carbonate
प्लैटफॉर्म	Platform
एचडीडी	HDD
2957	2957
एडीडी	ADD
शुरूआत	introduction
090	090
कोण	angle
विश्वसनीय	reliable
मस्ट	Must
गालियां	Abuses
अपशब्द	abuse
कट	cut
नजारे	View
2-in	2-In
मैग्नेटिक	Magnetic
पिन	Pin
समेकित	consolidated
खरीदते	Buy
खर्चा	payment
जोड़कर	Adding
तर्ज	Lines
स्पोर्ट	sport
21	21
34	34
27	27
ब्रोस	Bros
वॉर	War
ब्रो	Bro
पीक्सेल	Pixels
लक्ष्य	aim
वेदों	Vedas
ग्रंथों	Texts
वैमानिकी	aeronautic
पुस्तक	book
विमान	measuring
उड़ाने	Blowing
अकेले	alone
4.7	4.7
दिखाए	Shown
फ़िटनेस	Fitness
रिलेटेड	Related
फेनसांग	Fensang
मंगन	Mangan
Mangan	Mangan
सुगम	easy
शेक्सपियर	Shakespeare
हैमलेट	Hamlet
प्लेइंग	Playing
आरपीजी	Rpg
एक्सर्वस्ट	Exhaust
xburst	xburst
हुये	Happened
चिकित्सकीय	Dental
पुराणों	Mythology
हृदय	heart
पीठ	back
चिता	Pile of wood on which Hindus cremate their dead
माता	small pox
गिरा	tongue
भगवन	God
अंतिमसंस्कार	Funeral
184	184
फैबलेट्स	Phablets
ज्वाइंट	Joint
लोहे	Iron
क्लिप	clip
चटक	sparrow
शोज	Shows
पैठ	approach
नाईट	Night
4,000	4,000
हूबहू	Identically
पेनासोनिक	Panasonic
एचसी	HC
एक्स1000	X1000
4960	4960
यूएचडी	UHD
एचडी1920	HD1920
जानवरो	Animals
आप्टिकल	Optical
लाजबाव	Shame on you
डाइरेक्टर	Director
मगध	Magadha
मतभेद	difference of opinion
ढाई	two and a half
लीकिन	But
MIUI	MIUI
एकरूपता	uniformity
डॉन्गल	Dongle
5.2	5.2
इंत	Inthe
19999	19999
तीर्थयात्री	pilgrim
स्लिक	Slick
जंचे	
रिपेयर	Repair
बचपन	childhood
भूगोल	geography
पढ़ा	read
बढ़ेंगे	Will increase
बदलेगा	Change
पाओगे	Find
फ्लेप	Flap
पकड़ती	Grips
जॉम्बि	Zombie
गिरावट	decline
आराध्य	to be worshipped
हडिंबा	Hadimba
सृष्टि	creation
रचयिता	composer
महाराज	Your majesty
वशिष्ठ	Vashishtha
क्लब	club association
हाउस	house
गोंपा	Gonpa
ब्लोटवेयर	Bloatware
लापरवाही	carelessness
झलकती	Glimpses
फटती	Bursting
जीफ़ोर्स	Gefors
जीटी630एम	GT630M
इंस्पेकटर	Inspector
जाधव	Jadhav
डिटेक्टेड	Detected
ऑटोमैटिकली	Automatically
12000	12000
सूफी	Sufi
मोइउद्दीन	Moiuddin
चिरती	Chirati
2150	2150
गेस्ट	Guest
स्टे	Stay
कॉटेज	Cottage
डस्टप्रूफ	Dustproof
आर्इपी	IP
Yu	Yu
Yuphoria	Euphoria
कन्फ्यूजन	Confusion
चढ़ने	Climb
सूचित	informed
बदली	a stray cloud
1050mAh	1050mAh
On	On
खरीदार	vendee
भुगत	Suffering
मकबरे	Tomb
बदशक्ल	ugly
सिद्ध	saint
आईटैब	iTab
संयोजन	assembling
ब्लॉकबस्टर	Blockbuster
मेगाहर्ट	MHz
स्‍पीड	Speed
लुभा	Tempting
45.20	45.20
हिन्दुओं	Hindus
दुमका	Dumka
डिफेंस	Defense
लॉयर	Lawyer
प्रोसिक्यूशन	Prosecution
मायलॉर्ड्स	Mylords
वालयूम	Walum
रिटर्न	Returns
लैडस्केप	Ladscape
पकड़ते	Catch
समरूपता	isomorphism
पार	the other side
कमरों	Rooms
आडियो	Audio
नजाकत	Close
खोलिएगा	Open it
ज्यादाकर	Mostly
अफ्रीका	Africa
रच	Composition
बैटर	batter
पांएगे	Will get
S6000	S6000
इंटरटेनमेंट	Entertainment
560	560
किबोर्ड	Keyboard
डॉक	dock
27,000	27,000
रहित	devoid
1974	1974
टाईगर	Tiger
बेतला	
पलामू	Palamu
इमें	In these
थान्गू	Thangu
पहुँचते	Reach
फ्लूइडिक	Fluidic
एनिमेशन्स	Animations
540x960पी	540x960p
पोट्रेट	Portrait
डिटेक्शन	Detection
23990	23990
फुट	foot
दिवस	day
दिमागी	intellectual
7000	7000
विडियोज़	Videos
खतरे	Danger
1950mAh	1950mAh
त्रिशूल	trident
संबंधित	related
अनुकूलन	conditioning
बहकने	Wandering
संभाला	Handled
होंगें	Will be
टिल्ली	Tilly
गोबरंडा	Gobaranda
शिकारी	hunting
धनुषषबाण	Bow
रस्सा	A thick and strong rope
--	--
मटका	A large earthen pot like a pitcher
दौ़	Round
ड	The thirteenth consonant of the Devanagari syllabary
बोरा	gunny bag
दा़	
ैड	D
त्रिटंगी	Tritangi
बजनी	Ringing
[	[
कुश्ती	wrestling
]	]
लीपा	Lipa
पोती	granddaughter
कबड्डी	a game
प्रतियोगिताएं	Contests
रात्री	At night
नृृत्य	Dance
सांस्कृृतिक	Cultural
फिल्मकारों	Filmmakers
सितारों	Stars
फकीर	fakir
कार्यप्रणाली	procedure
करारा	crisp as a biscuit
प्रहार	assault
क्रास	Cross
वाइब	Vibe
तर्ह	Kind of
खुरदरी	Rough
फिचर	Feature
हॅण्ड	Hand
सॅमसंग	Samsung
गॅलेक्सी	Galaxy
जॅक	Jack
सैफ	Saif
जोन	zone
लौटे	Returned
बाप	father
रे	O !
फटी	Cracked
सड़कें	Roads
इमोशन	Emotion
रियलिरूट	RealRoot
सूक्ष्म	minute
झलकता	Reflective
नान	A big bread baked in an oven
Mi3	Mi3
स्मार्टफ़ोनआज	Smartphones Today
किफ़ायती	economical
मंद	slow
अजीत	Ajit
तिवारी	ti
फीका	insipid
5K	5K
आईमैक	iMac
ग्लोबल	Global
सर्वर	server
प्रतिस्पर्द्धा	emulation
आध्यात्मिकता	spirituality
मज़ेदार	tasteful
फिसलने	Sliding
चैतन्य	conscious
डेवलपर	Developer
स्लॉथ	Sloth
बियर्स	Bears
रेस्क्यू	Rescue
रिहैबिलिटेशन	Rehabilitation
गैलेक्‍सी	Galaxy
जेस्चर	Gestures
सेंसिंग	Sensing
मैजिक	magic
2500	2500
कनेक्टीविटी	Connectivity
Skywalk	Skywalk
Terrace	Terrace
कुर्सियों	Chairs
चुस्कियाँ	Kisses
निहार	light morning meal
भरोसेमंद	dependable
उभरते	Emerging
एलिगेंट	Elegant
डिलाइटफुल	Delightful
ब्रज	The region around Mathura U.P.
संस्कार	ceremony
ध्वनियों	Sounds
खलती	Slit
इंकी	Inki
डिमिंग	Dimming
जेन	Jane
भावुकता	sentimentality
फिल्मं	Movies
किरणों	Rays
प्रतीक्षा	waiting
बाहें	Arms
फैलाये	Spread
गौरतलब	Significantly
मामलें	Affairs
तांबे	copper
स्वर्ण	gold
चढ़ाया	Plated
अदाकारों	Actors
गोसिप्स	Gossips
लूजर	Loser
शम्मीर	Shammir
केदार	field
दुर्घटना	accident
पहना	case
फिल्ममेकर्स	Filmmakers
सब्सक्राइब	Subscribe
PC	PC
कड़े	Stringent
दबाना	to be compressed
अल्यूमिनियम	Aluminium
2002	2002
यूनीसेफ	UNICEF
इमारतों	Buildings
लजीज	Delicious
खाने	Eat
पिलाने	Drink
हें	He
गैलेक्‍टी	Galacticy
विंडोज़	Windows
लाइसेंसी	Licensed
साफ्टवेय	Software
करवाने	Have
पड़ेंगे	Will fall
S6300	S6300
Nikon	Nikon
Coolpix	Coolpix
9,652	9,652
93.6	93.6
57.7	57.7
36	36
फोकल	Focal
लेंथ	Length
25-250	25-250
ऑप्‍टिकल	Optical
125-3200	125-3200
6300	6300
ट्रैवलिंग	Travelling
लवर्स	Lovers
रहेंगे	Will
अंगूरी	wine
स्वास्तिका	Swastika
मास	month
परेशानीवाली	Troublesome
श्वेजनेगार	Respiratory
अड्डे	Base
शिकागो	Chicago
एक्सप‌र्ट्स	Experts
मैन्यू	Menu
धूम	smoke
सेलिब्रेट	Celebrate
ह	The thirty-third consonant of the Devanagari syllabary
साइडों	Sides
वितान	canopy
व्यावसायिक	occupational
लेटेस्‍ट	Latest
Lights	Lights
पट्टियां	Stripes
काबिलियत	Ability
ड्राइंग	Drawing
शब्दावली	vocabulary
Zync	Zync
बेचना	to sell
पढ़ें	Read
महकती	Smell
कल	yesterday
झूमते	Swinging
असफलता	unsuccessfulness
एक्सपीरिएंस	Experience
कानों	Ears
अपनाना	to own
टिम	Tim
जॉनसन	Johnson
पहाडि़यां	Mountains
मल्टिपल	Multiple
अवॉर्ड	Award
जीतने	Win
विवरण	an account
मुखर	talkative
रेस्पॉंसिव	Responsive
अधिकार	right
डिटेक्टिव	Detective
SDHC	SDHC
मेजरमेंट	Measurement
162	162
115	115
7.6	7.6
वेंटिलेशन	Ventilation
आईमॅक	iMac
साउंडलेस	Soundless
इयरफोन	Earphones
म्युजीक	Music
प्रूप	Format
कसर	want
देतीं	Give
उपनिवेशवाद	colonialism
बचा	escape
बैधनाथ	Baidhnath
आत्मलिंग	Self-sex
महेश्वर्लिंग	Maheshwarling
कमानालिंग	Arching
रावणेश्वर	Ravaneshwar
वैधनाथलिंग	Validating
नर्ग	Narg
तत्पुरुष	the Supreme Being
बेंगुनाथ	Bengunath
केबिल	Cable
सर्फ	Surf
स्‍टंट	Stent
गीकबेंच	Geekbench
प्रोडक्ट्स	Products
इटली	Italy
रॉयल	royal
6000	6000
जेनरल	General
पफार्मेंस	Performance
मालूम	known
0.78	0.78
cm	CM
bezel	Bezel
503	503
आशाओ	Hope
आनन्द	bliss
चौंकाता	Shocking
डिजाइनिंग	Designing
मेटैलिक	Metallic
9mm	9mm
भेजने	Send
बोल	utterance
चार्ली	Charlie
आठवें	Eighth
नौवें	Ninth
लैपकेयर	Lapcare
एक्सेसरीज	Accessories
लीडिंग	Leading
सन्तुष्ट	content
इंटेलीजेंट	Intelligent
वर्चुअलकी	Virtually
हबीब	darling
फैजल	Faizal
थ्रेड्स	Threads
जे5	J5
एडरिनो	Adrino
203	203
चैनल्स	Channels
आरई	Re
640XL	640XL
डाक्यूमेंट्स	Documents
तात्पर्य	Mean
आमिर	Aamir
निखरती	Improving
सेर्विसिंग	Servicing
सुव्यवस्थित	well ordered
कॉफी	coffee
झाड़ियों	Bushes
शक्ल	shape
बेतरतीबी	disorderliness
ढलानों	Slopes
दृष्टि	eyesight
games	Games
accelerometer	Accelerometer
gyroscope	Gyroscope
compass	Compass
barometer	Barometer
heart	Heart
rate	Rate
monitor	Monitor
पनी	Pani
मिटाने	Erase
मिसाल	example
भव्यता	splendour
जानना	To know
चोटें	Injuries
सह	gain
उतारना	to take down
जेस्च	Jesch
र	The twenty-seventh consonant of the Devanagari syllabary
फेशियल	Facials
रिक्गनिशन	Recognition
क्षमताएं	Capabilities
ऑफ़लाइन	offline
एयरबोर्न	Airborne
एरिएल	Ariel
नॉकडाउन	Knockdown
ड्रिफ्टिंग	Drifting
बालानंद	Balanand
ब्रह्मचारी	celibate
अनुयायी	follower
डोसा	dosa
मिक्स	Mix
मेकविलीब	Makevilleb
मसालेदार	seasoned with spice
कनेक्‍टीविटी	Connectivity
तस्‍वीरें	Photos
कोएक्सीअल	Coaxial
AV	AV
एक्सेसरी	accessory
घूमने	Roam
स्मार्टफोंस	Smartphones
दाएं	Right
वाॅलयूम	Volume
0.75	0.75
साहब	sir
हुसैन	Hussein
1964	1964
सी260-9.5	C260-9.5
सी260	C260
आल	All
इन-वन	In-One
साधन	mean
गर	if used in poetry
इन्‍नोवेटेड	Innovated
मल्टीस्क्रीन	Multiscreen
पांचों	All five
संजीदगी	seriousne
इनकमिंग	Incoming
कॉल्स	Calls
मेसेज	message
फ्लॅशी	Flashy
दिखावे	Appearances
कनवर्जेशन	Conversion
शुरुआती	initial
कंप्‍यूटर	Computer
विकल्‍प	Options
किल	nail
होस्टाइल	Hostyl
UHD	UHD
164	164
10.2.1	10.2.1
39,990	39,990
चलाये	Conducting
श्रीराम	Sriram
राघवन	Raghavan
टहलते	Take a walk
अवशेषों	Residue
निरंतर	always
चुनिंदा	choice
डॉक्टर्स	Doctors
शांतनु	Shantanu
मोइत्रा	Moitra
जगा	wake up
कै	vomit
मरों	Die
प्रोग्राम	program
कोनो	Kono
किरकिरा	gritty
निर्विवाद	undisputed
नोइज़ी	Noiji
वहाँ	there
डालता	Puts
पींग	swing
अनुशासित	disciplined
परिवार	Family
चुलबुली	Flirtatious
लड़की	The girl
उन्मुक्त	let loose
गुणों	Properties
व्यवस्था	set-up
अदजानिया	Adajania
फ्लैक्स	Flex
2-यह	2- This
समलैंगिकता	homosexuality
विकसित	bloomed
सेमी	Cm
1.35	1.35
आसपेक्ट	Impact
मोहताज	needy
बिता	spend
जेड50-यह	Z50-It
बेव	Web
खरी	The truth
देखनी	View
उठकर	Rise
असरहीन	Ineffective
न्यूज	News
उलझे	Embroiled
कनवर्टन	Conversion
याकों	Yaakon
दृष्टिगोचर	in view or sight
WIFI	WIFI
खेमें	Camps
नॉनवेज	Non-veg
खुलेआम	publicly
लतीफे	Latife
मजाकिया	funny
एसवीएस151115एफएनबी	SVS151115FNB
65,000	65,000
त्रुटिपूर्ण	imperfect
Customizable	Customizable
185	185
एस400	S400
इंटल	Intel
79	79
टिटेक्शन	Detection
करोड़	crore
प्वाइंट्स	Points
गर्माने	Warm
RCA	RCA
V	V
बैठते	Sit
बंधते	Tied
पेंच	screw
चलन	detached
जिनको	To whom
अनइनस्टॉल	Uninstall
ज़रूरी	necessary
डालते	Put it
जाइये	Go
ऑरिजिनल	Original
20.3	20.3
हाईब्रिड	Hybrid
H.265	H.265
MPEG4	MPEG4
REAL	REAL
डिकोडिंग	Decoding
पेनल	Panel
सरकारी	official
कर्मचारियों	Employees
दोपहर	noon
कार्यस्थल	workplace
पहुंचाने	Delivering
41,990	41,990
वेस्ट	West
पंजाबी	Punjabi
ट्रेनिंग	Training
सेफ्टी	Safety
रूल्स	Rules
विश्वास	faith belief
ईलाइफ	eLife
S7	S7
कॉर्निंग	Corning
वस्तु	thing
रगड़	friction
मचाया	Made up
फुटेज	footage
भयानक	terrible
अंगूठे	Thumb
शाहिद	Shahid
अंगीकार	acceptance
इलेक्ट्रॉनिक्स	electronics
इक्वेलाइजर	Equalizer
ऑडियोएफएक्स	AudioFX
3.5mm	3.5mm
रेसिस्टेंट	Resistant
वनवासी	forest-dweller
जन्तुओं	Animals
चलना	big sieve
परखें	Give
पाकिस्तावन	Pakistan
दुराग्रहों	Prejudices
पूर्वाग्रहों	Prejudices
तोड़ती	Breaking
जायक़ा	Taste
प्रॉपर	Proper
आयशा	Aisha
टीया	Tia
एवीआई	AVI
फार्मेट्स	Formats
इंटरटेन्मेन्ट	Entertainment
डेजीचेन	Dajichen
जोड़कर	Adding
अक्षरा	Akshara
हासन	Hassan
डेब्यू	Debut
50,000	50,000
एक्यूटाइप	Acutype
एकात्मता	Oneness
टाइटल	Titles
ब्राविया	Bravia
ओह	oh! ha! good heavens!
एफिल	Eiffel
टॉवर	Tower
कोलेप्स	Coleps
अडिशनल	Additional
फर्स्ट	First
ब्रॉडकास्ट	Broadcast
नोटिफिकेशन्स	Notifications
औ	The eleventh vowel of the Devanagari syllabary
मकराना	Makrana
खानों	Mines
मंगवाया	Ordered
न्वाइस	Voice
कैंसिलेशन	Cancellation
टेकनोलॉजी	Technology
स्पोर्टी	Sporty
एक्सवर्स्ट	Exhaust
Play	Play
मर्जी	pleasure
ब्लिंक	Blink
रेखा	line
बोलने	Speaking
दिलवाने	To get
सेंसर्स	Sensors
प्रतिक्रियाओं	Responses
स्ट्रेस	Stretch
ऑक्सीजन	oxygen
हटाया	Deleted
रिस्पॉन्सिव	Responsive
मार्गरिटा	Margarita
विद	With
स्ट्रॉ	straw
बेटों	Sons
बारीकी	finene
10.5	10.5
उधर	there
खिसकाकर	By slipping
किरणें	Rays
प्रशस्त	praiseworthy
रहीं	Stay
ईयरफोन	Earphones
SATA	SATA
6Gbit	6Gbit
ट्रेडिशनल	Traditional
तिरछे	awry
धसेंगे	Will collapse
पॉलीकार्बोनेट	Polycarbonate
करेइ९न	Do 9n
13-इंच	13-inch
साइज़	size
डिलीवरी	Delivery
जी6	G6
हनीकॉम्ब	Honeycomb
वाबजूद	Despite
मालाएं	Garlands
जबरवान	Tremendous
तलहटी	foothill
खिलने	Bloom
गुलाबी	of rose
ऑरेंज	Orange
आदी	habitual
भ्रमजाल	Confusion
प्यारी	darling
गीयर	gear
वायलेंस	Violence
क्रम	order
खरीददारी	shopping
अनुभवी	experienced
राज	kingdom
डोस	Dos
करवा	A pot with a spout
माइनिंग	Mining
मिलिट्री	Military
सियाचिन	Siachen
रिसीव	Received
कराने	To do
आअप	You
स्‍पेसिफिकेशन	Specification
आमने	Face
समानांतर	parallel
राहुल	Rahul
तेजस्विनी	Tejaswini
कोल्हापुरी	Kolhapuri
रोनित	Ronit
खोलना	to open
अनावश्यक	unnecessary
सिटी	City
अरब	one thousand million
डच	Dutch
पुर्तगाली	Portuguese
छाप	stamp
फार्मेट	Format
विडीयो	Video
ग्रेट	Great
एरिया	Area
1366x768	1366x768
संकल्प	resolution
कपल्स	Couples
अमृतांजन	Amrutanjan
ड्यूक्स	Deux
नोज़	Noz
रेवुड	Raywood
भुशी	Bhushi
वीडीयोज	Videos
शुद्ध	pure
इंस्टा	Insta
ड्रेन	Drain
कोनों	Corners
मैटे	Matte
एमटीएस	MTS
MTS	MTS
बंडल्ड	Bundled
कता	cutting
बेवकूफियों	Idiots
मजबूरी	compulsion
बहादुरी	bravery
आयामों	Dimensions
एनएक्‍स	NX
मिररलेस	Mirrorless
आउटपूट	Output
झुके	Bow down
2,29,999	2,29,999
2,39,999	2,39,999
1.33	1.33
नवंबर	November
1983	1983
22वें	22nd
सेशंस	Sessions
अनुमोदन	approval
पैनासोनिक	Panasonic
एलुगा	Eluga
5-इंच	5-inch
चमकीले	Bright
नारंगी	Orange tree and its fruit
रंगा	coloured
जंगला	post-and-rail frame
भड़कीला	glittering
ELPH	ELPH
130IS	130IS
ट्रेडीशनल	Traditional
ए5	A5
ज़्यादातार	Mostly
विनिर्देश	specification
बिताना	to pass
मेन	main
प्वॉइंट	Point
खुशी	pleasure
पोर्टेट	Portrait
एप्‍स	Apps
एक्सपैंडेबल	Expandable
उखड़	Uprooted
कैलेंडर	calendar
सूचनाएं	Notifications
स्वतः	per se
वनस्पतियां	Flora
जीवजन्तु	Animals
उत्साहियों	Enthusiasts
ब्राइटनेश	Brightness
स्लीप	Sleep
वेक	wake
आईआर	Ir
बीम	beam of timber
निभाती	Plays
रचते	Creating
लगाव	relation
पूजते	Worship
शिवलिंग	Shiva’s stone phallus which represents the God
शहद	honey
चंदन	sandal
बेलपत्र	Belpatra
घुमाया	Rotated
अचेत	senseless
लेटे	Layte
ठंढा	cold
अल्युमिनियम	Aluminium
रामकुमार	Ramkumar
डॉ.	Dr.
चंद्रप्रकाश	Chandraprakash
द्विवेद्वी	Dwivedi
राजनीति	politic
कसती	Tight
आला	niche
सटायर	Sattire
ESPN	ESPN
रमणीय	beautiful
दिनभर	Throughout the day
सबमें	In all
पायदान	Footboard or footrest meant to facilitate getting into a carriage
उच्चारण	pronunciation
पशुपतिनाथ	Pashupatinath
हिन्दूतीर्थ	Hindu pilgrimage
अफसरों	Officers
समग्र	aggregate
मांगने	Seeking
एक्सपर्ट	Expert
बुलाने	Call
डोलो	Dolo
मांडो	Mando
1,999	1,999
CNY	CNY
बताई	Told
परंपराओं	Traditions
बनेघर	Building a house
इंटिग्रेटेड	Integrated
पावरवीआर	PowerVR
SGX544	SGX544
1.5GHz	1.5GHz
मीडीया	Media
MT6589T	MT6589T
कृष्णों	Krishnas
निराले	Unique
जरूरतें	Requirements
त्रिकूट	Trioat
660	660
430	430
सामंजस्य	harmony
निहायत	excessively
अनूठी	Unique
आभूषणों	Jewellery
भरतनाट्यम	Bharatnatyam
स्टनिंग	Stunning
पोतैमेदु	Potaimedu
महत्त्वपूर्ण	important
कॉर्पोरेट	corporate
वर्ल्ड	World
डोक्यूमेंट्स	Documents
डिजिटली	Digitally
प्रमाणित	attested
प्रयोगवादी	experimentalist
किस्सागोई	Story
फिल्मकार	filmmaker
उत्सर्जित	abandoned
स्वीकार्य	Acceptable
हस्तक्षेप	intervention
विचलित	gone away
लाइन्स	Lines
दोहराते	Repeating
polycarbonate	Polycarbonate
एल्‍युमिनियम	Aluminium
कैप्‍सूल	Capsule
चमकीली	glossy
फिंगरप्रिंग	Fingerprinting
केंद्रित	centred
वर्णन	description
रूक	Stop
2000	2000
ब्योकेश	Byokesh
बंद्योपाध्याय	Bandyopadhyay
वॉयसओवर	Voiceover
सुरखाब	Surkhab
game	Game
मूनस्टोन	Moonstone
मिलनेवाली	To be found
सॅन्डस्टोन	Sandstone
चिकने	Smooth
लखनऊ	Lucknow
अभिषेक	consecration
बच्‍चन	Bachchan
सूद	profit
क्सपीरिया	Xperia
रिसोर्ट	Resort
व्यवसायियों	Businessmen
लायें	Fetch
एक्सेसीबल	Accessible
सिफ़ारिश	recommendation
विभाजन	division
कंगाली	poverty
किरण	beam of light
जुड़	Added
वायफाय	Wifi
मालवेयर	Malware
5.3	5.3
चौड़ा	wide
40एमबीपीएस	40Mbps
एमकेवी	MKV
सैंपल	sample
फॉर्मेट्स	Formats
नॉथ	Noth
लंदन	London
लांचर	Launcher
घुसे	Entered
कच्ची	Raw
चमत्कारिक	wonderful
दबावों	Pressures
बचें	Avoid
बचाया	Saved
14,999	14,999
उपलब्द	Available
उलट	overturn
S6Edge	s6Edge
सेल्सियस	Celsius
मोड़ा	Turn
वोएज	Voage
ईपेपर	ePaper
बैरोमीटर	barometer
गेयरोस्कोप	Gyroscope
कंपास	compa
केसिंग	Casing
महीनों	Months
बदरंग	of shabby colour
धुंधली	Hazy
श्राॅफ	Shroff
अनफिट	Unfit
हब	hub
स्टोरी	Story
मेकर	Maker
बीबी	respectable woman
सुपर्ब	Superb
रिजल्ट	Result
एनर्जी	Energy
दक्ष	skilful
हालंकि	However
इसमे	In this
केपेबिलिटी	Capability
12,000	12,000
जांचने	Check
295	295
मीडीयाटेक	MediaTech
MT6592T	MT6592T
1.7GHz	1.7GHz
Mali450	Mali450
MP4जीपीयू	MP4GPU
लूट	plunder
पुनर्निर्माण	reconstruction
385	385
हटते	Delete
लाता	Brings
.86	.86
बडे	Big
हैंडल	handle
चिंकारा	gazelle
वन्यप्राणी	Wildlife
Quad	Quad
Core	Core
Processor	Processor
पाउंउ	I will get
सुनकर	Hearing
जीव	creature
जंतुओं	Animals
पाना	to receive
यद	However
जनजाती	Tribal
रीति	method
रिवाजों	Customs
उड़ीसा	Orissa
महानदी	Mahanadi
बागमती	Bagmati
प्रेमी	Boyfriend
अद्वितीय	unique
उलझती	Confusion
उलझाती	Confused
पैराग्राफ	paragraph
संसकरण	printing
लम्‍बा	Long
स्नोफॉल	Snowfall
गिराकर	Dropped
अस्तित्व	existence
फिल्माए	Filmed
अतिरंजित	exaggerated
21900	21900
बनवा	cause
कैरेट	carat
गोल्‍ड	Gold
उपलब्‍ध	Available
बहुराष्ट्रीय	multinational
उद्यमियों	Entrepreneurs
निगलने	Swallowing
टैब्स	Tabs
खोले	Opened
एक्सेल	Excel
स्प्रेडशीट्स	Spreadsheets
आइट्यून्स	iTunes
चाहतों	Wishes
मिनिएचर	Miniature
फॉर्म	Form
साइन्स	Signs
सिग्नल्स	Signals
ब्रेकर्स	Breakers
फायदे	Advantages
7mm	7mm
नमकीन	saltish
मगरमच्छ	crocodile
11.6-इंच	11.6-inch
इवन	Even
स्मार्टफ़ोन्स	Smartphones
कब	when
शरीफ	sheriff
ध्वनि	sound
गुरुद्वारा	Gurudwara
सरप्राइज	Surprise
खैर	the tree acacia
कबी	Kabi
Kabi	Kabi
Phensang	Phensang
जपते	Chanting
हाइ	Hi
थ्रीडी	3D
