কেউই	None
চ্যান্সেরি	Chancery
শো	Show
ইচচা	Ichcha
মারে	Murray
মহিলা	Women
বসুন্ধরা	Bashundhara
ব্যবসা	Business
আফগানিস্তান	Afghanistan
না–ও	No-
দরকার	Need
ডির	Dir
আমরা	We are
বিদায়	Goodbye
উপর	On
হয়নাই	It didn't.
বাপ	Father
হারামিপনা	Haramipana
হইছে	It's
শিখ্যা	Learn
ভারতিয়	Indian
আসবেন	Come
হিন্দুস্থান	Hindustan
নের	Ner
২৩	- 23
কলকাতার	Kolkata
হিন্দুকে	To the Hindu
জন্নতে	Janne
দুজনে	Both
কুওার	Quayer
আসবা	Come on
সেলিব্রেটি	Celebrities
পাবনাতেও	In Pabna
পতাকার	The flag
ত	T
ভালবাসে	Love it
পাচ্ছি	I get
পাচা	Pacha
কুব	Kub
শেষে	Finally.
টয়া	Toy
পীরদের	Peers
সালের	Of
দাওয়াত	Invitation
ভোটদিয়ে	By voting
মদ	Wine
চেহারার	Appearance
টাকা	The money
চুদমু	
সালার	Salar
কিনে	Buy
শোয়ামিজি	Shoamiji
মাদদোমে	Maddome
সুদখোর	Interested
সংগীতের	Music
আতি	Ati
বারবারই	Again and again.
কার	Whose
পাথ	Path
মাজখান	Majkhan
বিশ্ব	World
পুরসকার	Purskar
ব্যাগে	In the bag
মালাউনের	Maloon's
আওয়ামিলিগ	Awami League
আর	And
কাঠমোল্লা	Wood molasses
কিচ্ছু	Anything
জনগনের	The people
কাউয়া	Kaua'i
আস্তে	Slow
ফখে	Foche
হইলে	If so
সাময়িক	Temporary
বীর্যের	Semen
বেটা	Beta
সহিংসতা	Violence
মুসলমানদেরকে	Muslims
আস্তাো	Astao
হারামযাদা	Haramzada
হারামী	Harami
অসাধারন	It's awesome.
ইন্ডিয়ারাই	Indians
দের	Of
আলমগির	Alamgir
চলিত	Moving
কুলংগার	Kulangar
পদে	Positions
বারি	Bari
এইদশা	This is
খেতে	To eat
বেটারে	Better
ভাবার	Thinking
বন্যা	Flood
বিয়া	Bea
চরম	Extreme
ঘৃনিত	Hated
পায়ের	Feet
আরেক	Another
সালাল্লাহু	Salallahu
জিয়াই	Ziai
বক্সচুদ	Boxchuck
পাগলা	Crazy
আইসস	Ices
দশকের	Decades
বাঙালিরারা	Bengalis
পঞ্চাশ	Fifty
জীবন	Life
টানে	Pulled
জুলাই	July
চাইতেছে	Wants
এত্ত	It's
হবেনা	It won't.
মানুষ	People
গুয়া	Gua
পাকিশতানি	Pakistan
সৌভিকের	Souvik's
কুতা	Kuta
দেয়া	Given
লাগল	It felt
বিকারগ্রস্ত	Disoriented
প্রশ্ন	Question
শুরু	Start
সোজা	Straight
কাটাকাটি	Vandalism
মুকদিয়ে	With a mook
এগিয়ে	Moving forward
পরোষরা	Parasites
পিতামহ	Grandfather
স্থাপনে	In placement
খানকিমাগী	Khankimagi
তৌহিদ	Towhid
কমানো	Reduced
একজন	A
বারাবারি	Barabari
যথেষ্ট	That's enough
অাইতাছি	Itachi
তুইত	Tuit
বুজলাম	I understand
চোদাচুদির	
বিবেক	Conscience
কাংকির	Kanki
থাকলে	If
তিনি	He
িতপতী	Titpati
প্রকৃতপক্ষে	In fact
শুতে	To sleep
সন্ত্রাসী	Terrorists
বাপে	Father
মারলে	If you kill
আল্লা	Allah
মলের	Malls
গিয়ে	Going
করো	Do it
ব্যারিস্টার	Barrister
ফেতনা	Fetna
ডুকান	Ducan
লইয়া	Take it
নাকি	Or
ফসল	Crops
খানকিরে	Khankire
গুলি	Bullets
যারা	Who
ক্লাসলেস	Classless
প্রচার	Feed
বলবো	I'd say
হুজুর	My Lord
জামাতের	The Congregation
ইমু	Emu
খাইলি	Eating
খাটে	On the cot
জিনিস	Stuff
দেবতারা	The gods
হবে	Would be
আহ	Ah
আপনাকে	You
ভুদা	Voodoo
সন্ত্রাসি	Terrorists
বেজন্মা	Unborn
শয়েতানের	Satan's
দেখে	See
টায়া	Taya
আরম্ভ	Begin
কইরা	Kaira
টিভির	TV
ফুল	Flowers
দ্বারা	By
তখন	Then
পুরুষদের	Men
পিরিয়ড	Period
আসবে	It will come
ছুচো	Chucho
ফুন্দে	Funde
নেকেই	In the neck
বাংলাদেশিরা	Bangladeshis
ইসি	Isi
ছিরতে	To rip
বিরুধী	Oppose
আজব	Strange
তখনই	If
৬০	- 60
আপন	Yours
হুরের	Hurrah
পুলা	Pula
ভাবো	Think about it
পুজা	Pooja
শক্ত	Tough
লাভ	Profit
পির	Pir
বাহির	Outside
খমতা	Khamta
ছুদেন	Chuden
বুরা	Bura
থাকবে	Will
মাড়াচ্ছিস	You're beating
প্রধান	Main
শুনলে	If you listen
ঔষুধ	Medicines
চুত্মারানির	Chutzpah
দিল	Dil
হেডার	Header
নিজেদের	Own
সিল	Seal
বিকাশ	Development
দেয়	It gives
গাই	Guy
শরম	Autumn
মাহী	Mahi
তৈয়ারি	Tayari
সমাজটাকে	To the community.
বুঝিনা	I don't understand
কোরে	Corey
চিল্লাতে	In chilla
হও	Be it
বেশী	More
রাখতে	To
পাকিশতান	Pakishtan
গো	Go
জবাব	Reply
তিন	On three
কোথাকার	Where
ধর্ষিতা	Rape victims
একটি	A
সুষ্ঠু	Fair
অথবা	Or
গদফাদার	The donkey
তাকিয়ে	Looking at
মারেন	Maren
সমস্যা	Problem
গাবি	Gabby
দিতে	To give
চূদো	Chudo
বেয়াদব	Nonsense
বরিশাল	Barisal
পড়	Read on.
ব্যাকগ্রাউন্ড	Background
মানুশকে	To Manush.
বুড়ার	The old man
মধ্যেই	In
শোওফিকের	Shoufik's
মতন	Like
আপনারা	You
পাকা	Ripe
ইন্ডিয়ান	Indian
জোটগতভাবে	In alliance
বলা	To say
জুতো	Shoes
থাকতেন	He lived
আমাদের	Our
নিজেরে	In itself.
কয়	How much
আপনাদের	You
বিমানেই	On the plane.
বেথা	Betha
আপনি	You
ভুূদা	Voodoo
নেহি	Nahi
টুকাই	Tukai
এইসব	These
পেটে	In the stomach
শালায়	In-laws
পতি	Pati
এদেরকে	Them
সালে	In
কুত্তার	Dogs
কাউকে	Someone
দুনিয়াতে	In the world
প্লিজ	Please
গোলা	Gola
অতাচার	Austerity
ধাক্কা	Push
আৱবেৱ	Attitude
নোংরামী	Filth
উদয়	Emergence
ওদের	Their
গোল	Goals
মিস	Missed
এক্কেবারে	In unison
প্রজন্মের	Generations
জনক	Father
নাম	Name
হওয়ার	To be
তাও	Also
আতাত	Atat
ক্ষমতায়	In power
লাগবে	Needed
বহু	Many
তাহলে	So that
নির্দেষ	Directional
আবর্জনা	Garbage
ও	And
রেল	Rail
পড়ছিল	It was reading
কখনোও	Never
দোষী	Guilty
ইন্টারনেট	Internet
হয়	It is
নামটা	The name
মাঝখানে	In the middle
রাজাকা	Rajaka
চায়	Wants
হ্যাঁ	Heck yes
বাঁশ	Bamboo
তুইলা	Tuila
চিনাল	Chinal
বাড়ি	House
দিক	Aspects
ফকির	Fakir
মাদাদর	Maddar
মুসলিমের	Muslims
পইড়া	Poira
উটছে	Camels
চলছে	Running
পাকিস্থান	Pakistan
বাছা	Picked
করছে	Is
শক্তি	Power
অপরাধীরে	Criminals
প্রতিযোগিতা	Competition
পোরবি	Porby
৫০	- 50
গরুর	Cows
মুগের	Moong
সন্ত্রাসীর	Terrorists
চুসে	Sucking
লোক	People
যায়	Goes
যাবেন	Go
নিছে	Niche
মেরেফেলা	Killed
বছর	Years
তারেকের	Tarek's
লাভটা	The benefit
অনলাইনে	Online
গের	Ger
জংলী	Junglee
পাইক্কা	Pykkah
প্রস্রাব	Urine
টকশো	Talk show
বাচ্ছারা	Children
জা	Sister in Law
হুইসেল	Whistle
নিয়া	Nia
মাথার	Head
পোতিতাদের	The potions
দুটো	Two
কাছ	From
রেন্ডিয়া	Randia
হয়নি	Not
চেষ্টা	Try
কিনবা	Buy
100ভাগ	100%
এটাই	That's it.
শয়তানের	Satan's
হারামিরে	Haramire
শয়তান	Satan
ভাষা	Language
ওরা	They
সীমাবদ্ধ	Restricted
চুদাচ্ছে	
হয়	It is
তরমারে	In the sword
খেলপ	Play
আসিফের	Asif's
উঠে	Up
হচ্ছিল	It was
থেকে	From
ভারতে	In
গেলহৈ	Galai
মায়ানমারকে	To Myanmar
চলেছে	Continues
হয়েছিল	Was
২বছর	2 years
অবস্বই	Of course
শালারপুতেরা	Shalaraputera
চুদবো	I'll
ছাড়িয়ে	Beyond
গুণ	Attribute
হাসিনার	Hasina
ফইন্নি	Foynni
লুচ্চা	Lucha
দিত	It would
কারাগারে	In prison
লুটে	Looted
পানের	Paan
ভালগার	Valgar
করিস	Do it
নিজেরই	Itself.
হাগায়	In Hagay
মেয়ে	Daughter
কথাবার্তা	Talk
হে	Hey
কেউ	Someone
হতে	From
আসলিই	Asli
প্রভার	Cover
গণধোলাই	Mob lynching
খোমোতা	Khomota
মধ্যে	Among
চুদলে	
বুকে	On the chest
চোদনা	
মায়া	Maya
কামাল	Kamal
চার	Four
বাইগন	Bygon
বিষাক্ত	Toxic
লোকই	People
বাশের	Basher
মূর্খদের	Fools
গুন্ডার	Goons
চোদামু	
ষড়যন্ত্রের	Conspiracy
খাওয়ায়	Feeding
বুদ্ধিমান	Intelligent
মুতুন	Mutun
সুচিকে	To Suchi
ভন্ড	Hypocrites
অধিষ্ঠিত	Occupied
সাল	Year
তারউপর	On top of that
স্পষ্ট	Explicit
বলিষ্ঠ	Strong
সুতার	Yarn
সোনা	Gold
নিরাপদ	Secure
হারে	Rate
বাংলায়	In
মাওবাদী	Maoists
শ্ৰী	Mr.
একজনই	Only one
লাইফে	In Life
তুমিতো	You
তারাই	They are
বেশি	More
ঢুকানোর	Insert
অামি	I
করত	It did
শখ	Hobby
কমিশনের	Commission
দোয়া	Prayers
লাফ	Jump
জনগণ	People
আজকের	Today
দান	Donations
মূর্তি	Statue
একটারে	One at a time.
করছেন	Are
ইতিহাসের	History
অবাল	Abol
চীনা	Chinese
পারবে	Can
আকাশের	The sky
ডিজিটাল	Digital
সরকার	Government
৮০	- 80
সাজতে	To dress up
বাঙ্গালির	Bengalis
ইন্ডিয়া	India
একই	Same
চিনলেও	Even if you know
দেব	Dev
অতই	That's it.
গরেরমাগি	Goermagi
৩০	- 30
বদরুচ্ছুদা	Badass
রক্ত	Blood
চ্যাটের	Chat
ভোটের	Voting
চালু	On
করচ্ছে	Doing
দিয়া	Diya
হয়ে	Be it
পার্থ্য	Parthia
জাত	Caste
সুসলমান	Susselman
ঘন্টার	Hours
রেডি	Ready
আমারদের	Mines
শাসনে	In governance
গুম	Disappearance
জন্ম্য	Born
খুলে	Opens
পোরজনত	Porzingis
দায়	Responsibility
অবস্থার	State
ই	E
সমাবেশ	Gathering
কোরবানির	Sacrifice
সেইটা	That's it
হিন্দুরাই	Hindus
নাকিরে	Or
গুলোর	Of
তাড়িয়ে	Driven out
গেদা	Geda
অন্যদের	Others
আসাম	Assam
কেঁচো	Earthworms
টয়লেটে	In the toilet
সমন্বয়ে	In coordination
সম্প্রচার	Broadcast
খাইতাম	I used to eat
এহন	Eh
শিখা	Learning
অন্যান্য	Other
চুদাইতেছে	
ধংশো	Vandalism
সহ্য	Tolerating
ডঃ	Dr.
তুলনা	Compare
কল্যাণের	Welfare
জুতা	Shoes
নোয়াখালীর	Noakhali
পুরায়	In the whole
উপস্থাপনা	Setup
যেই	That
সালাদের	Salad
মুহম্মদের	Muhammad's
মুলমানদে	Mulmande
জবাই	Slaughter
খা	Eat
দিচে	Diche
ব্যবহার	Use
কোরিয়ান	Korean
বসবাস	Living
চব্বিশঘন্টা	Twenty-four hours
রাজাকারের	Razakar's
মুস্লিমগুলা	Muslims
হয়না	It doesn't.
জারোজ	Jaroj
তেল	Oil
কেও	Who
আছেন	Are
বাচছা	Bachcha
দেশের	Countries
প্যান্টি	Panties
শুয়োরখোর	Pigs
অশিখিতো	Unlearned
করেনি	Did not
সৌদি	Saudi
তারাতে	In the stars
ব্যাংকের	The bank
পার্থভাই	Parthbhai
বারবার	Repeatedly
আচুদা	Achuda
চুষে	Sucking
রাখিস	Keep
যেনো	As
মি	Mr.
চুদাইলে	In the chudail
জংলি	Junglee
গেছেন	Gone
ব্যক্তি	People
মাত্রাতিরিক্ত	Excessive
প্রাচীন	Ancient
এশিয়ার	Asia
ইতিমধ্যে	Already
বাচ্চারা	Children
খ্রিস্টানদের	Christians
কমেন্টের	Comments
ওঠাটাই	Getting up
সলিমুল্লাহ	Salimullah
শিবই	Shiva
কলংক	Stigma
উত্তরদাতা	Respondent
দালালরা	Brokers
এদেশে	In this country
বলবি	Say
দেখিয়ে	Showing
চুদায়	
সৃষ্টি	Create
বিচারপতি	Judge
মতু	Motu
জাবে	Jabe
মার্কা	Marka
গোটা	The whole
চুলাকায়	In the oven
পোদ	Pod
সুদাতাম	Sudatam
মুজিবর	Mujibur
বুদা	Buda
৬	- 6
অই	That's it.
জংগি	Jungy
দেখার	See
পাচাও	Pachao
সময়টাতে	In time
দেশকে	The country
ধুকাইবার	Dhukaibar
হত্যাকান্ডের	Of murder
আইমিন	Aimin
কৃপণ	Ugly
আছো	Are you
কুমার	Kumar
সানতি	Santi
মক্কল	Makkal
ভিবাহ	Vibah
বাপের	Father's
মানচিত্র	Map
সবুজের	Green
পাগলদের	The madmen
সাউআর	Sawyer
যুদ্ধের	War
আওমীলীগ	Awami League
খায়তে	To eat
আইন	Law
দিয়েছে	Has
বাচ্ছা	Boy
ডুকাইচে	Ducatche
প্রধানমন্ত্রী	Prime Minister
নির্দিষ্ট	Specified
করছি	Am
কাটাতে	To cut
মালাউনকা	Malaunka
রাখসে	Keep it
অফিসার	Officer
বুকের	Chest
কামড়	Bite
বাস	Live
লাথ	Lathe
পুরূষ	Men
লাড়ালাপ্পা	Ladalappa
চৌধুরী	Chowdhury
হইলো	It was
থাকিস	Stay
ছেলেটা	The boy
নায়ক	Heroes
ভিকারী	Vikari
ধর্ষণকারি	Rapist
রহ্মা	Mercy
প্রবাসির	Expatriates
মান	Value
আইসে	Ice
কিসের	Of what
আয়	Income
ভোদাটা	Vodata
শালারপুতরা	Shalaraputs
গুলোতে	In
আসা	Coming
দেশে	Country
বড়লোক	Grown-ups
একবারে	At once
বাংলাই	Bengal
সাধীন	Under
পরল	Wear
হতো	Was
আসনের	Seats
আগামিতে	In the future
কপাল	Forehead
ফেল	Fail
পুলিশদের	The police
লোকেরা	People
আবিষ্কার	Discovery
সভাপতি	President
শালিকে	Shalike
অপমান	Insults
ইন্ডিয়ার	India
বডিলেংগুয়েজ	Bodylanguage
চরিত্র	Character
শেখ	Sheikh
সাপ	Snakes
পূত	Putt
পাঁচ	Five
রা	Ra
মিয়া	Mia
ত্রখি	Trivia
তেমন	Like
পিষ্যা	
খবিস	Khabis
নর্দমার	Sewers
চুলকোতে	In the itch
চুদী	
হল	Is
অফিসারদের	Officers
চাল্লা	Challa
বেডারে	In bed
তোরা	You
ততদিন	Until then.
ভোদাতে	In vodka
তের	Thirteen
অপরিচিত	Unknown
জাহান্নামি	Hell
ক্যামেরার	Camera
রেপার	Rapper
দৃষ্টি	Vision
বিড়াল	Cats
কুত্তালিগের	Kutlig
ঢাকের	The drum
ভুগ	Suffering
নিরাপত্তা	Security
দফা	Point
খারা	Khara
শুণ্য	Zero
স্পর্শিয়া	Touchy
পোষাক	Clothing
মিডিয়া	Media
বেসি	Bessie
নিচে	Below
থেকেই	From
বাংলাদেশর	Of Bangladesh
করেছিল	It did
প্রমান	Evidence
পারে	Could
মাগিরে	Magire
একশো	One hundred
প্রহরীর	The Guard
স্থানে	Location
ব্যাসালয়ে	In the basilica
চক্রান্ত	Conspiracy
সাত	Seven
বারমা	Barma
বলদা	Balda
পানি	Water
হিজরায়	Hijra
ঘারেনিছে	It's been done
ক্রিমিনাল	Criminal
দেশবাসী	Countrymen
বিজিবির	BGB
একদিননা	Not for a day.
লালন	Nurture
পাছা	Ass
দেই	Let's give
প্রত্যন্ত	Remote
মারাইছ	Marais
ফাটাও	Crack
তাঁরা	They
প্রিথিবি	Prithibi
ব্যবসায়ী	Businessman
মাগিদের	The Magi
পৃথিবী	Earth
বোনেরে	Sisters
ভাইয়া	Brother
আউল	Owl
প্রকৃত	Original
বুজাযায়	Understandable
মাধ্যমে	Through
গুদের	
পাঠামু	Send it
বিচারাধীন	Pending
নির্দেশনা	Instructions
অডিসনে	At Audition
বুঝলো	Got it.
ছাগলে	Goats
চ্যানেল	Channel
পার্টি	Party
কৃমি	Worms
বাচ্চাদের	Children
ব্রিটিশ	British
থামাতে	Stop
উপ্রে	Upre
খেলে	Playing
রিকুয়েস্ট	Request
ভড়ুয়া	Bharua
চোদাও	
পাকস্তানে	In Pakistan
উপস্থাপন	Setup
হেয়ার	Hair
ডা	Dr.
মোখের	Mokher
হ্লা	Hla
তে	To
কমেন্ট	Comments
ছে	It's
বাঙ্গালি	Bengali
পাবি	Pub
এগু	Moving on
দেখুন	See
আলতা	Alta
হবেই	It will be
পিটাই	Pitai
২০১৮	2018
সম্ভবতো	Probably
করেছ	You did
ফেল্লা	Fella
বুদার	Buder
স্টেজ	Stage
জাতীয়	National
তুই	You
লোচ্চা	Locha
বাংলাদেশি	Bangladeshis
দামে	At the price
নরপিশাচ	Norpishch
ভবনটি	The building
চাইতে	To want
কোথাই	Where
৪৪	- 44
ঠোটের	Lips
সিন্ঘাপুর	Sinhalapur
ইসলামে	In Islam
মাকেও	Mother too.
মায়ের	Mother
বাঘ	Tiger
ফোটা	Drops
সুযোগ	Opportunity
বেড়াতে	To visit
হালার	Haller
১৯৭১	1971
কিনা	If
হজরত	Hazrat
মেনে	Accepted
জাহান্নামির	Hell
রাজনীতিতে	In politics
আয়েশ	Aisha
বদনাম	Notoriety
অনুসারি	Followers
বাংলাটাই	Bengali
উন্মত	Unintended
শুনা	Listen
তারানো	Tarano
কারো	Someone
অসোহাই	Asohai
হলো	Is
এগের	Egger
সালারা	Salara
পর্ণ	
খানকিরা	Khankira
মজিব	Mojib
মন্তী	Monty
স্বার্থে	For the sake of
মস্তিকের	Of the brain
নিতে	Take
ভেতর	Inside
তাঁর	His
ঝরাতে	To fall
বেঁচে	Surviving
করলেই	If you do
রাজি	Agreed
মাঝে	Between
হলেও	Although
এগুলো	Them
শেবন	Shebon
চলেযাক	Let's go
কুততি	Sockpuppetry
চুদেই	
চেয়ে	Than
রাজাকার	Razakar
ইউসুফ	Yusuf
পোচাতে	To poach
উপায়	Way
একন	Akon
কেড়ে	Taken away
মুসলিম	Muslim
তো	So
মিনাজের	Minaj
বর	Groom
মুহাম্মদ	Muhammad
পাক্না	Pakna
আসোলে	Asol
মন্দ	Bad
চলবেনা	It won't work
কিন্তু	But
রোহিঙ্গাদের	Rohingyas
নামবার	Namebar
উনি	He
নেস	Ness
বৌয়ের	Bowie's
ক্যান	Can
পারিনা	I can't
তারেক	Tarek
জিয়ারত	Ziarat
দেইখা	Deikha
পোলাদের	Poles
তাঁড়ানো	Removing
তোরেচুদি	Torechudi
ধুইয়া	Washed
মায়ে	Mae
ভিজে	Wet
সরকারি	Official
২০	- 20
শিকার	Hunting
বললেও	Even if you say
তোমাগো	Tomago
বাংলাদেশ	Bangladesh
ধরমে	Dharam
যথাযথ	Appropriate
মাগিই	Magii
কাজের	Work
লাগাইসো	Lagaiso
জোরে	Loudly
কুতথার	Kuthar
চালাবে	Will run
ড	Dr.
সুচির	The needle
আরও	More
যাবে	Be
কথাকার	The narrator
৭০	- 70
পুরো	Whole
আনে	Brings
প্রণয়ন	Formulation
ভালো	Good
যাওয়া	Going
খেয়েছ	You ate
মুসলমান	Muslim
সুখ	Pleasure
ম্যাগাজিন	Magazine
খিদে	Hunger
কমিশন	Commission
মাঠিতে	In the field
তরা	Tara
কডোম	Codom
দ্ধে	
ইন্ডিয়ান	Indian
না	No
ডাকাত	Robbers
কাছে	Have
ঐক্যফ্রন্টের	The United Front
দ্যা	The
উল্টা	Upside down
দরচে	In the bargain
মাগির	Magyar
এদের	Them
সঙ্গে	With
এগোলো	Move on
ভাল	This is good
ম্যাচ	Match
যাব	I'll go
ইহুদী	Jews
বুজবি	Buzby
বলতেছস	You say
রাজপরিবার	The Royal Family
করবি	Will
রাকিস	Rakis
নবীর	The Prophet
সম্রাট	Emperor
দালালদের	Brokers
যুদ্ধ	War
সারাদিন	All day
দেবীরা	Goddesses
করল	Did
হেতিরে	Hetire
ইতিহাস	History
আবালের	Abal's
কখনো	Never
পাড়ার	Neighborhood
কমু	Comma
মাদারচুদেরে	
ছোট	Small
গল্পের	Story
মুল্লাটা	Mullata
দুনিয়াতেই	In the world
নেকামি	Nekami
বিনোদন	Entertainment
ইসলামের	Islam
লম্পটগিরি	Lameness
বোর্ড	Board
বেচারা	Poor man
কিছু	Some
পূর্ব	East
জনগন	People
বিভক্ত	Split
চিরশত্রু	The eternal enemy
জামায়াতের	Jamaat
করেছে	Has
দিলেও	Even if it did
কুত্তা	Dog
তাদেরকে	To them
দিলি	Dili
রাজনীতি	Politics
পারি	Can
টুয়া	Tua
সম্পর্ক	Relation
মাগীচুদা	Magichuda
অনন্য	Unique
ফ্যামেলি	Family
দেখি	I see
কোথায়	Where is
ভোদায়	In the oven
লস	Los
খমতার	Khamtar
যাতায়াত	Travel
নিজে	Itself
তিনিই	He is
পাই	Pi
খাইয়া	Eat
শীল	Sheel
মেজাজ	Mood
সেবা	Service
কথা	Talk
পোলার	Polar
বাশ	Bash
বাংলাদেশিরাই	Bangladeshis
কালা	Black
জাহান্নাম	Hell
কম	Low
প্রকাশ	Publish
যাদের	Those who
ভাই	Brother
আমার	My
করসিলাম	Corsilam
রাস্তায়	On the road
বাইমান	Byman
ভুল	Incorrect
চুদা	
লই	Loi
খাইত	Eating
রাগ	Anger
পোত	Pot
খাওয়াচ্ছে	Feeding
নিকিষ্ট	Niche
এখতিয়ারটা	Jurisdiction
ছিছিছি	I've
মাফ	Apologies.
মহা	Big
জারজ	Jarz
সেখানে	Over there
ফরজ	Obligatory
জায়গা	Space
বিচারক	Judge
ইংরেজী	English
মুজিবের	Mujib's
রেখে	Keep
অতি	Most
বউরে	In the wife
লীগের	League
হুর	Hooray
বার	Bar
হোওআর	Howar
মার	Mar
বুঝলাম	I get it.
ফালাই	Falai
মানেই	I mean.
হির	Heer
তোকে	To you
জন্য	For
কুলঙ্গার	Kulangar
বৌদ্ধ	Buddhist
রিপ্লাই	Reply
চু	Chou
পরই	After
থিক	Thick
জননাঙ্গ	Genitals
নুংরামী	Nungrami
অগত্যা	Anyway
লিমিট	Limits
টাইপ	Type
নামে	Name
বেসসা	Bessa
ছবি	Picture
মিলে	Together
যাইতাম	I'd go
লাইভ	Live
দন	Don
মাটি	Soil
ভাইয়েরা	Brothers
ভিডিওর	Video
আলোচনা	Discussion
শিশুকামী	Childlike
বেডি	Buddy
বলতে	Tell
প্রকাশ্য	Public
খুনি	Murderer
শুয়ারের	Schuyer
পাদেন	Paden
মেধাহীন	Meritless
বেস্ট	Best
এখন	Now
জান্নাতি	Paradise
বলতিস	Boltis
দূর্গা	Durga
পায়ের	Feet
বগ	Bog
নেওয়া	Taken
নিয়ে	With
গাবীন	Gabin
সকালে	In the morning
৫৩	- 53
মুহম্মদকে	Muhammad
খিচুড়ি	Khichdi
ইহুদিরা	The Jews
জুলুম	Tyranny
পারেনাই	Couldn't
হত	Had to
নায়িকা	Heroine
ওগো	Ogo
দালালে	To the broker
মিয়া	Mia
১	- 1
লজ্জা	Shame
থাকত	It used to be
সাথেই	With
সম্মান	Respect
গেল	Gone
মুখ	Mouth
গণতন্ত্র	Democracy
মাগীরে	Magire
সহিংশুনতা	Violence
জাবাবও	Jabab too.
সুধু	Sudhu
মহিলারা	Women
সমাজে	In society
পাঠাবে	Send
ডাকবি	Call
বলদের	Balls
ভুধার	Bhudhar
বদনা	Badass
৪৫০	- 450
গন	Gon
অাচার	Ethos
বদলায়া	Changed
আসল	Original
য়ের	Of
শ্রধ্বেয়	Shradheya
কোরো	Do it
যাচ্ছে	Be
এইসসব	These are all
অপরাধী	Criminals
১৫০আসন	- 150 Seats
কর্মীর	Employees
পটর	Potter
সপ	Sop
বলেন	Said
মাগিকে	Maggie
হারামজাদি	Haramzadi
ভিতরে	In
চরকায়	Charkay
মুর্তিপুজারী	Murtipuzari
হিরু	Hiru
অাছে	It's
কনে	The bride
শনাম	Shanam
১টা	1 p.m.
যতদিন	As long as
রাসতায়	Rastay
কুত্তালীগে	In the dog's league
বরেগেছ	Boregay
গটপাদার	Gotpadar
ফান	Van
নামেও	In the name of
তবে	But
গিয়াছে	Gone
টেলিভিশন	Television
কেলাচিছলো	Kelachillo
অত	So much
থাকরে	Stay
খুন	Murder
বাপেরা	Fathers
কস	Cos
পছন্দ	Options
মরিছ	Died
হালারে	Halare
লাগছে	It looks like
জোট	Alliance
চুদারা	
খাইস্টা	Khaista
চেয়ারম্যান	Chairman
অশিক্ষিত	Uneducated
জি	G
সময়ে	Time
পশ্চিমবঙ্গ	West Bengal
ভেসে	Floated
জগোতা	Zagota
হাইওয়ান	Hione
ইচ্ছে	Desire
বাংলা	Bengali
অভিযোগ	Complaint
রাষ্ট্রের	The state
মাগিবাজি	Magibaazi
সফটপর্ণের	Softporn
বুক	Chest
কি	The what
মোটেও	Not at all.
বিলাবার	Bilbar
বাহিনী	Forces
নডির	Nodir
শ্রাবনী	Shrabani
মামলার	The case
বলেছেন	He said
জনের	John's
জাতের	Breed
বেশামরিক	Bessamrik
পরিবার	Family
এইকতা	This
চোদাইতে	
কিন্ত	But
জেলে	In jail
উন্নয়ন	Development
অনেক	A lot
গ্যাংব্যাং	
ইউনিয়নের	Union
কীভাবে	How
উনার	His
ইসির	THE EC
ইচরে	Icher
চুলের	Hair
খাদাম	Khadam
ছিল	Had been
ফালতু	Nonsense
হাহাহা	Hahaha
পুলিশের	Police
দিমো	Dimo
আল্লার	Allah
বংগবন্ধুর	Bangabandhu's
খাঙ্কি	Khanki
গোয়া	Goa
মেরুকরণ	Polarization
পাকিদের	Pakistanis
নানা	Nana
কারনে	Because of
হওয়া	Be
কুকুর	Dogs
বিজতে	Bijate
তুর	Tur
ইন্ডিয়ার	India
বচন	Speech
জেনে	Knowing
আসবেই	It will come
হয়ে	Be it
জাতির	Nation
ছেলের	Son
নির্যাতিত	Tortured
বুজে	Understanding
কুখ্যাত	Infamous
আইনকে	The law
এতিম	Orphans
পার্ট	Part
আরব	Arab
লাগিয়ে	Put on
জুগগোতা	Juggotta
দেখতেই	To see
দেখতে	To watch
স্পর্শীয়া	Tactile
গর্ভবতী	Pregnant
আধম	Half
তাদের	Their
মুরগির	Chicken
মিল	Similarities
ব্যাহত	Disrupted
সংস্কৃতিকে	Culture
নিলেন	Taken
পোলা	Pola
আব্রাহামিক	Abrahamic
৷	.
পাগলে	Crazy
দিয়েছে	Has
শোও	Show up
কুত্তালীগ	League
বিভিন্ন	Different
গজব	Thunder
কুলাঙ্গার	Black sheep of the family
রফতানি	Exports
মিনিটের	Minutes
পাকিস্তানিরা	Pakistanis
দূর	Remote
নিতি	Niti
জিতি	Win
মতো	As
ত্রিশ	Thirty
ডুকিয়ে	Diving
বান্দির	Bandy's
মোল্লা	Mullahs
দেখায়	Shows
যাইগা	Go
আসেনা	It didn't come
কানকির	Kankir
হাসপাতালে	In the hospital
সিফাত	Sifat
আসছো	You're coming
আসে	Comes
বাস্তবের	Reality
বললি	Said
কাশ্মীর	Kashmir
অত্যাচারের	Persecution
করবেনা	Don't
বউকে	To the wife
খেতো	Eat
জাজ	Jazz
ঘাটে	At the pier
হাছিনা	Hasina
দোষ	Fault
সাপোর্ট	Support
গলায়	In the throat
আতঙ্কবাদী	Scaremonger
পারনা	You can't
চায়না	China
বসেছে	Sitting
করালেন	Done
অসভ্য	Uncivil
ছেড়ে	Leave
জানাজা	Funeral
মনোনয়ন	Nomination
বাসে	On the bus
আসন	Seats
ইতিহাসবিকৃতিকারী	Distortion of history
তৃণমূল	Grassroots
করতেসে	To do
বডিল্যাংগুয়েজ	Bodylanguage
ইসলামকে	Islam
মুক্তি	Release
ভেদধব	Discrimination
ইসলাম	Islam
নিজেরাই	Themselves.
মায়েরে	Mother
তো	So
পরিচয়ের	Identity
পেয়েছেন	Got it
আসলে	In fact.
চাঁদা	Donations
রেজা	Reza
কুত্তায়া	The dog
নোংরামীর	Filth
দিস	This
মাগীবাজি	Magibaazi
খানকিৱ	Khankiw
পিলখানা	Pillkhana
যাত্রা	Journey
দেবো	I'll give
পাকির	Pakir
মাধার	Madhar
ভবন	Buildings
প্রয়োজনীয়	It's important
সোনাটা	The sonata
করলেন	He
হোল	It's
মরিস	Morris
সবচেয়ে	Most
রোবট	Robots
বেড়েই	Growing
দেওয়া	Given
মুত	Mut
ছিলো	Was
গুরে	Gure
বানিয়ে	Created
করেদেয়	It did
বেসরমা	Besarma
খারাফ	Kharaf
নাভি	Navel
বড	Baud
প্রবেশ	Access
জানিস	You know.
খাবি	Eat
দেশবাশি৷	Country.
বেইশ্যার	Bayshire
জ্বালা	Irritation
জঙ্গি	Militants
বিনময়ে	Binmay
কল	Call
মুর্খ	Stupid
পাকার	Ripe
বুঝতে	To understand
রাখ	Keep
ভোট	Vote
হাটের	The market
বিদ্বেষী	Haters
যখন	When
পায়খানা	Toilet
দিয়া	Diya
দুজনই	Both
গাজাখুরী	Gazakhuri
বকলম	Nonsense
ইনড়িয়া	Indya
দিয়ে	With
সাঃ	Saa
শেটাই	Setai
ধমঁ	Dham
মিছিল	March
ঘরের	The house
পরে	Later
আইছে	It's coming
দিবেনা	Don't give
বাপরে	After
অদিকার	Adika
দুদু	Dudu
দল	Group
অসম্ভব	Impossible
আগে	Before
পারো	You can
মালুদের	Malud's
স্বাধীনতা	Independence
নিত্য	Constant
মাহিলাদের	The Women
পুরাতন	Old
বুকা	Buka
মারছে	Killing
পার্থ	Perth
খাবো	I'll eat
ফেলতাম	I'd throw it away.
পিতা	Father
এনাকোন্ডা	Anaconda
খায়	Eats
আাবাসিকে	To the aborigines.
আরম্ব	Arumb
দূতাবাস	Embassy
আজাইরা	Azaira
গুলো	The
অজ্ঞ	Ignorant
ভারত	India
ভোদাই	Vodai
কালিকে	Ink
ছিলেন	Was
বর্তমানে	Currently
কামানোর	Earning
বরেগেছে	It's gone
উন্নয়ন	Development
সবকিছুই	Everything
ডুকাই	Ducai
চোদরা	
করন	Do
লোভে	In greed
যেমনে	As in
পয়দা	Poyda
এতো	So much
শিওর	Sure
ফাঁস	Leak
ব্যপার	Things
বাসার	Home
মোটা	Bold
পুন্দামু	Pundamu
রাম	Ram
করনে	In doing
মিয়ানমার	Myanmar
দেশত্যাগে	Emigration
অতিষ্ট	Fed up
লাল	Red
শিব	Shiva
অবস্থা	Status
হোটেল	Hotel
করিছ	You did
মাদক	Drugs
মডেল	Model
নিয়া	Nia
টুকরো	Pieces
মরা	Dead
সেদিকে	Towards that.
প্রতি	Per
মেয়েদের	Girls
রাজনিতি	Politics
আমলেও	Even in time
সামনে	Front
দিমু	Dimu
হাতে	In hand
জন্মের	Birth
সমাগম	Gatherings
সাবস্ক্রাইব	Subscribe
ফকিন্নির	Fakinni's
তর	
ঘুম	Sleep
নিন্দা	Condemnation
যার	Which
নাইকের	Nike
দেশেই	In the country
যাওয়ার	Go
হাসানো	Laughing
জিয়াকে	Zia
হব	I'll be
আসামের	Of Assam
মালটা	Malta
ইস	Iss
ইন্ডিয়া	India
আওয়ামী	Awami League
গাঁজা	Cannabis
চায়	Wants
এমনিই	That's it.
উহহ	Uhhh
আবালই	Abalai
সিইসি	CEC
বাড়ছে	Growing
ভাইব্রাদার	Brother
সন্তানেরা	Children
বুঝি	I understand.
হিসাবে	As
বেগুন	Eggplant
এসিড	Acid
জাকির	Zakir
রাস্ট্রপ্রধান	Head of State
টিক	Tick
উদ্দেশ্য	Intent
ম্যপ	Map
ভো	Woh
সেবন	Consumption
পোংগা	Ponga
কমই	Hardly
মাজারপুজারী	Mazarpuzari
বিএনপি	BNP
বলবে	Will say
উল্লাহ	Ullah
বিশ্বাস	Trust
সুরেন্দ্র	Surendra
মনটায়	In mind
বাগানের	The Garden
রনখেত্রকে	To Rankhetra
একসাথে	Together
শুরুতে	Earlier
হোক	Be it
তোর	Yours
এখতিয়ার	Jurisdiction
হাঃ	Hah.
তোমারে	To you
কিরকম	How about
ঢুকাইয়া	Inserted
পিকে	PK
গেলী	Geli
হাতি	Elephants
খাই	Eat
মারবে	Will kill
আল্লাহ	God
জমাত	Gatherings
ইচ্ছা	Wish
যে	The
ফেরাওন	Revert
শালার	Shaler
মারমুখী	Beatings
পসুর	Pasur
নেই	Not
নিজেরা	Themselves.
যতই	As much as
নিরপেক্ষ	Neutral
মুসলিন	Muslin
থাক	Stay
বিজ	Biz
হাজার	Thousand
অস্ট্রেলিয়াসহ	including Australia
বাইঞ্চদ	Binched
ইরাক	Iraq
সঠিকভাবে	Correctly
শান্ত	Calm down
মরিচ	Pepper
বেপার	Bepar
ভরা	Filled
মিলীগ	Milligan
চেহেরা	Chehra
শুদু	Shudu
শিলপ	Shilp
আসনে	In the seat
মাহীবি	Mahibi
পতিতালয়ে	In the brothel
স্বামি	Swami
টয়ার	Toyer
শালীর	Shali
গেছে	Gone
বে	Bay
বাঙ্গালী	Bengalis
নামের	Name
হিজড়া	Hijra
পুরাই	The whole
গালি	Abuse
ওরজিনিয়াল	Orginal
হারিয়ে	Lost
চুরি	Theft
নারী	Female
ফেলতেছিস	You're throwing it away
এনিওয়ে	Anyway
সাহেবকে	To the Sahib.
ব্যবস্থা	System
চুদাতে	To
ভাগে	Into
পড়ুন	Read
শিক্ষা	Education
আস্লেই	Ashley
বোকাচোদা	Stupid
বলদ	Bullock
নোংরামি	Filth
কারণ	Because
নাম্বারের	Numbers
প্রাণিটার	The animal
শেষ	Last
গানের	Songs
কিট	Kit
ইসলামী	Islamic
পাবেনা	Don't get
আওয়ামীলীগের	Awami League
দালাল	Brokers
দুন	Dune
হুইন্না	Huinna
বানাও	Make it
যুবলীগ	Jubo League
দেখবি	You'll see
বৃত্তি	Scholarships
ইতর	It's
শহর	City
পানির	Water
প্রতিশোধ	Revenge
আহা	Aha
খাওয়া	Eating
কথাই	Talk
ধর্ষক	Rapist
গারদে	Garde
চীন	China
টানার	Pulling
গঞ্জিকা	Ganjaka
তোমার	Your
দ্রারিদ্র	Dridur
প্রনেতা	Protagonist
গাধা	Ass
বন্দীর	Prisoners
আল্লহর	Allah
ট্রাম্প	Trump
বড়	Large
ছড়ায়	Spreads
রেপাররা	Rappers
করুন	Do it
এরকম	Like
নির্বাচনের	Selection
অাওয়ামিলীগের	Awami League
গারদ	Gard
জানতা	You know.
হাতের	Hands
রহিঙ্গাদের	The Rohingyas
জনগণের	People
হিন্দ	Hind
যেত	It went
সবগুলো	All
জগতে	In the world
উত্তর	North
প্রতিগ্গা	Pratigga
যুক্তি	Logic
ফ্যামিলিকে	To the family.
ইহুদীরা	The Jews
অনুষ্টান	Ceremonies
সাহায্য	Back up
তেরে	Terre
ঘরে	At home
একটুও	Not a bit
সানি	Sunny
যতসব	As much as
লাঠির	The stick
সত্যি	True
নিরপক্ষ	Neutral
বিচ্ছিন্ন	Disconnected
ভোধা	Bhoda
চলে	Let's go
ছামারের	Chamar's
শরীরটা	The body
চেস্টা	Trying
খানকি	Khanki
ধিক্কার	Rebuke
অন্তত	At least
যায়নি	Could not
মতে	Opinion
স্পর্শীয়ার	Touchyer
ছারেন	Remove
রাখো	Keep
বুজিনা	Boozina
জল	Water
বিদেশ	Abroad
অপবিত্র	Unclean
পেয়েছিস	Got it
ডুকানোর	Ducanor
শিশুকামিতা	Child sexuality
জিয়া	Zia
লিঙ্গ	Gender
দুইটাকে	Two
খান্কিমাগি	Khankimagi
খাটি	It's a bit of a
পিটাইতাম	I was beaten
থ্যাই	That's it.
নয়	Not
বাংলাদেশীদের	Bangladeshis
মান্নাদের	The Mannas
কিছুইত	Nothing
দুর্নীতিতে	In corruption
তদের	Their
লীগকে	To the League.
বেসসারা	Bessara
বলতেছে	It says
যেভাবে	As
দরষন	Bargaining
গন্ড	Gond
করতেন	He did.
একটা	A
হেয়ার	Hair
মনে	In mind
বিচার	Trial
মুসলিমরা	Muslims
চোরের	The thief
সরি	Sorry.
প্রগতি	Progress
কন্ডম	Condoms
বেহেশতে	In Paradise
৫ম	The 5th
মুসলমাদের	Muslims
ফেরাঊনের	Pharaoh's
পমান	Pomon
কারি	Curry
পতিদিন	Patdin
প্রাঙ্ক	Prank
বাচ্চারে	The child
যাবার	To go
মেয়ের	The girl
নিস	Nice
কুকুরের	The dog
খোলা	Open
ভোদা	Vodka
তারি	That's it.
হালচাষ	Ploughing
সভা	Meeting
উচিত	Should
মারবো	I'll kill
রোহিঙ্গা	Rohingya
শিয়াল	Fox
চামচামী	Spoonfulness
পুলাপাইন	Pulapine
অতন্দ্র	Atindra
নিঃসন্দেহে	Of course.
রেমিট্যান্স	Remittances
বিচারে	At trial
জদি	Jodi
সমথর্নযোগ্য	Supportable
চুদমো	
গায়ে	On
জিলু	Zilu
সুবিধা	Privilege
আছেনি	There is no
আস্থা	Trust
আলমও	Alam also
দিবি	Diby
ভোদার	Vodder
চেলি	Chelly
খালেদা	Khaleda
কল্নক	Kalnak
মানদের	Standards
প্রিথিবী	Prithibi
নাও	Not
সৌদির	Saudi
চরমোনাই	Charmonai
আছে	Is
টানলেই	Pulling
কুততিই	Kuttii
আসেন	Came
মাইয়া	Maya
দেশটা	The country
অগ্রযাত্রা	Progress
ইনশা	Insha
ভীতু	Scared
মুক্তির	Release
দিন	Day
আড্ডা	Chat
লেজে	On the tail
হিনদুদের	Hindus
মাহফুজুর	Mahfuzur
যুক্ত	Add
শুয়োরের	Pigs
বোনদের	The Sisters
2ই	2E
নব্য	Modern
চোধুরী	
চুদের	
পাইছস	Get it
মরলে	If you die
আধা	Half
৩	- 3
হা	Ha ha
খান	Khan
কলকাতা	Kolkata
চুদল	
আনা	Brought
আবুইল্লা	Abuilla
পোশাকটা	The dress
চালিয়ে	Continue
ওয়ার্ল্ড	World
কামাই	Earning
বস্তাভর্তি	Full of sacks
বুদাদিয়ে	With Buda
বর্বরতা	Vandalism
দিতাম	I would give
মাদারচোদ	
করুম	I'll do it
আনসাবস্ক্রাইব	Unsubscribe
জয়	Joy
্যাচার	Etch
ফাইজলামি	Faizlami
নাখোচ	Nakhoch
সবাই	All
চুইতে	Chewy
ফালাইয়া	Falaiya
সীমার	Range
ভাইকে	Brother
সকলেরও	Everyone too.
তীব্র	Intense
নাস্তিকরা	Atheists
ছেলেকে	Son
ঐক্যফ্রন্ট	Oikya Front
দলটি	The team
দেইনি	I didn't
বাইনচোদ	Bainchod
ডুবিয়ে	Sinking
যাদেরকে	Those who
কইয়া	Where
শিবিরের	Camp
আবারো	Again.
ফেরাউনের	Pharaoh's
বাঙালী	Bengalis
ধরষন	Dharan
করতেছি	I'm doing
পারবি	You can
শিখছি	I'm learning.
ছিটকে	Knocked out
করার	To
বুয়ার	Buer
ছিলা	It was
হিনদু	Hindu
ঠিক	Sure thing
আগেই	Before
এতোই	That's all.
বিপদ	Danger
জামায়াত	Jamaat
আ	A
পাবনা	Pabna
দৈব	Divine
মধ্য	Central
বলার	To say
জাতটাই	The breed
সঠিক	Correct
দিয়ায়	Diy
করছ	You do
দ্রোহি	Treason
দেস	Des
শিরোনাম	Title
মেয়েরা	Girls
যুবরাজ	Prince
পা	Feet
হলি	Holly
জিগারের	Zigger's
বাড়িতে	At home
নিরপক্ষে	Absolutely
দিলো	Given
খমা	Khama
দরুন	Due to
চুর	Chur
পার্টির	Party
বয়ান	Statement
মায়ানমার	Myanmar
মুক্ত	Free
ভাবে	How about
ধনেরা	Riches
বাব	Babe
শিখিত	Learned
আজাদ	Azad
বুদ্ধি	Intelligence
একদিন	One day
আইলো	Aiello
রাজনিতির	Politics
ডিজিটালাইজেশনের	Digitization
মরবে	Will die
রাস্তার	The road
দেখতেছে	It looks
দেখত	See
খারায়া	Kharaya
দেখেত	See
গুঁতাগুঁতি	Guttural
কনভারসেশন	Convergence
বারুদ	Gunpowder
ফেলা	Fella
ঘেউ	Ghew
মজির	Mojir
স্যালুট	Salutations
ছেলে	Son
রাজনৈতিকভাবে	Politically
করেছি	Have
বুজার	Buzzer
উপমহাদেশের	Sub-continent
কাফেরদের	The infidels
বাস্টার্ড	Bastard
স্থাপন	Established
রড	Rod
অ	Non
খেদানো	Khedano
ব্যাপারে	You
পুজো	Worship
লীগ	League
তসলিমা	Taslima
কাম	Work
ছাগলরা	Goats
করনা	Don't
হিয়ালী	Hiali
হতা	Hota
তাড়াতেই	To chase
সেক্সি	Sexy
বিম্পির	Bimpy
উন্নয়নের	Development
লেংটা	Langta
স্বেচ্ছায়	Voluntarily
কেমন	How
৮০র	- 80
সালাম	Greetings
গোস্ত	Meat
দেওয়া	Given
ছাএ	In the shadow
এসব	These
খাইয়ে	Eating
বেইমানি	Dishonesty
বারা	Bara
পক্ষে	In favor of
চাগল	Chagall
বুজতাছিনা	Don't understand
হবি	Howie
অত্যাচার	Torture
থাকো	Stay tuned
গুলোকে	To whom
খাইতে	To eat
বাংলাদেশে	Bangladesh
এবার	Now
র	
সংগীত	Music
হওয়ার	To be
শুনতে	Listening
জীবনের	Life
আজাদের	Azad's
জম	Jam
এগুলোর	Of these
খুনী	Killer
ছেয়ে	Done
বেকুবই	Stupid
ব্যাবসা	Business
দুই	Two
বাস্তব	Real
দুধ	Milk
গালী	Galley
পুটকি	Putki
সমালোচনা	Criticism
ইয়াহুদি	Jews
বিএনপিকে	TO BNP
বাসটারড	Basterd
হুরেরা	Hurrahs
সানিউর	Sanyur
ছুদ	Chud
মুহম্মদ	Muhammad
প্রয়োজনে	If needed
সিনহা	Sinha
চিরন্তর	Eternal
জন্ম	Birth
সালা	Sala
মিটাস	Mitus
জটিল	It's complicated
টু	To
পাছায়	In the ass
সৌর	Solar
চিৎকার	Shouting
ভালোবাসা	Love
সন্তান	Child
বমি	Vomiting
ফাউল	Fouls
ঐ	That
এগুলি	These
মুফাখেতা	Mufakheta
আসি	Come on
খাওয়ার	Eating
ভরে	Filled
দেবতা	Gods
ইউটিউবার	YouTuber
ওর	His
খাইছে	Eaten
কাদে	Cry
চাপাবাজ	The chap
শালি	Shali
পড়স	Read it
দিছস	Give it
পাশের	Next to
দিও	Give it
সরকারকে	To the government
অহংকারেই	In pride
মাগি	Magi
আহহ	Ahah
ফকস্থানী	Falkstani
বলোনা	Don't tell me.
সেসকরলি	Sescorli
ক্ষমতা	Capacity
প্রবাসে	Overseas
পাগোল	Pagol
কোরতে	Korte
নাহলে	Otherwise.
নিমক	Nimak
নাস্তিকেরা	Atheists
অবস্হা	Status
কথার	Words
মজা	Fun
চুসানোর	Sucking
টা	It's
কেন	Why
মালিক	Owner
অাওয়া	Wow.
কতো	How much
যেমন	Such as
গঠনের	Structure
যেন	So
পুলিশ	The police
আকাম	Akam
হয়েছি	I've been
মুসলমানদের	Muslims
মিডিয়ার	Media
লো	Lo
কেমরাতে	In Kemrat
বলদার	Baldar
ছোটা	Small
মৃত্যু	Death
আদর্শ	Standard
কুত্তাও	Dogs too
মাদারচুদ	Motherhood
ওয়ান	One
খলিফা	Caliph
বিছানায়	In bed
সমান	Equal
বাজাঁরে	Playing
চলবে	Will continue
মেমে	Meme
সম্পৃক্ততা	Involvement
আসামির	The accused
গোলাম	Golam
দুইটা	Two
রাজ্যের	The state
করবে	Will
কেটা	Kata
মেরুদণ্ড	Spine
ছেরে	Torn
পুতেরা	Putera
পতিতালয়	Brothels
কাটমোললারে	Cutmoller
পৃথক	Different
কাংলাদেশের	In Bangladesh
বাংগালীদের	Bengalis
মানুষকে	People
পারিস	You can
দালালি	Brokerage
ছেলেদের	Boys
মুসলমানরা	Muslims
এদেশের	This country
৯১	- 91
নেয়ার	To take
এলিয়েনরা	Aliens
নির্বাচন	Select
সাজুএই	Sajue
বৈশাখ	Baishakh
মুল্য	Value
মোনে	Mone
নস্টা	Nosta
ফারাক্কার	Farakkar
আঁছে	It's
পড়ছে	Reading
আঙ্তাবাদী	Anglicanist
চাইনিজ	Chinese
নং	No
আগুনে	On fire
দিবে	Will
খারাপ	Bad
গেচে	Gache
প্রতিষ্ঠান	Organizations
চুদতে	To
মিশশা	Mishsha
শান্তিতে	In peace
অটিস্টিক	Autistic
আসিফ	Asif
ভারতেরর	India's
কাফের	Infidels
নেতৃত্ব	Leadership
ছেয়েচে	
বক্তব্য	Statement
তেতুল	Tamarind
আইক্কাওআলা	Aikkawala
ধ্বংস	Crash
রাখার	Keep
বাশডলা	Bashdala
বিশ্বের	World
দুদমারানি	Dudemarani
ক্ষ্যাত	Decay
কথায়	In words
নিজেগ	Itself
শিখব	I'll learn
বুঝা	Understanding
২টার	2 p.m.
তাই	So
সে	He is
অপেক্ষা	Wait
করছিল	It was
নেরি	Neri
পাকিস্তানি	Pakistan
ভারতেও	In India too.
কেননা	Because
ঝাপিয়ে	Jumping in
অন্য	Other
মক্কা	Mecca
বেটার	Better
কয়দিন	How many days
পিটাইছিলো	It was beaten
কাপে	In the cup
দেখছি	I see
উভয়	Both
মারার	Marr
স্পরশিয়ার	Spursier
যেটা	That
পশম	Fur
বন্ধুর	Friend
বিচানায়	In the bibliography
হেটার	Hater
নোংরা	Dirty
করুক	Do it
রবীন্দ্রনাথের	Rabindranath's
চিন	China
বোদা	Boda
চুদাবো	
দিকে	Towards
বিবেচনা	Consider
কালো	Black
পচাববেন	To rot
শত্রু	The enemy
পাকিস্তানদের	Pakistan's
লাইছে	Lyche
কেবল	Only
মাংগের	Manger
কুত্তারে	In the dog
দেখলেই	See
মানায়	It fits
ধম	Dhamma
কিতা	Kita
ঘৃনা	Hate
চোদা	
পেলে	Pele
ভাগ	Divided
তুমার	Yours
এন	N
আওয়ামীলীগকে	To the Awami League
লাতি	Lati
ছাগল	Goats
ভেড়ীর	The sheep
প্রধান্মন্ত্রির	The Prime Minister
প্রশ্ন্যটা	The question
কেরিয়ারকে	Career
পচানি	Rot
কী	Key
বাংলার	Bengal
কপি	Copy
চামচা	Spoons
মেয়েকে	The girl
বলসিলা	Bolsila
অন্যায়	Injustice
কচুদেও	Even in the butt
বেইমান	Dishonesty
করিছে	It did
কাংলুদের	The Kangloos
আর্মি	Army
মাগীদের	The Magi
এ্যাওয়ার্ড	Awards
নিয়মিত	Regular
ভড়	Bhar
শায়ালাকে	To Shayala
কই	Where?
টাকে	To
বুজস	Boozs
আরে	Hey.
দন্দে	Dande
পারফেক্ট	Perfect
পণ্যের	Product
হাগু	Hague
সাম্প্রদায়িকতা	Sectarianism
টক	Talk
ছুধানির	The needle
মহাসড়কে	On the highway
এডেটিং	Editing
পাকিছতানিরা	Pakistanis
খাইনা	Don't eat
নৈতিকভাবে	Morally
মেয়েটা	The girl
আগ্রাসী	Aggressive
চূড়ান্ত	Final
কত	How much
বাজেচৌধুরী	Badchaudhuri
মাল	Go
সত্য	The truth
বেলে	Belle
জলে	In water
সাতে	Seven
এনি	Annie
জানি	Know
মারা	Died
রাস্ট্র	State
অাথির্ক	Ethics
সামনের	Coming
জানে	I know
খুশি	Happy
কন্ঠ	Voice
আতঙ্ক	Panic
গা	Ga ga
যেসব	Those who
ইনশাআল্লাহ	Inshallah
যেখানে	Where
চোখ	Eyes
সাম্প্রদায়িক	Communal
সালির	Sally
চায়তাছে	Wanting
অসাধারণ	Awesome
ওয়াশিংটন	Washington
শিখতে	To learn
খাইলেও	Even if you eat
পিস	Peace
লোভি	Lowey
নির্বাচনে	Election
আমিও	Me too.
সক	Sock
জিয়ার	Zia
দালালী	Brokers
এমন	That
গার্মেন্টস	Garments
দিব	I'll give it
গেলাম	I went
শালারা	Shalara
চুদেছে	
পার্লামেন্টারি	Parliamentary
মহিলার	The woman
ভুদায়	In bhuda
সিয়াম	Siam
সোদাও	Sodao
মূর্খ	Stupid
আল্লাহর	God's
এরশাদ	Ershad
বসতে	To sit
মুলুক	Muluk
জায়গা	Space
জিতবে	Win
ভবনটা	The building
তাড়াতাড়ি	Quick
কনসার্ট	Concert
পরিবর্তন	Change
পাল	Pal
উপস্থাপক	Presenters
সজাগ	Alert
ধর্মের	Religion
ভয়	Fear
আমারে	Me
মদেদ	Made up
প্রতীক	Symbol
গরের	Gore
এইগুলোও	These are also
লাগাইছোস	You're going to
লেগ	Leg
বাবার	Father
দুধে	In milk
মায়ানমার	Myanmar
মালা	Mala
খবিশ	Khabish
পারবেন	Can
বিয়ে	Marriage
চুড়ে	Chute
রবীন্দ্রনাথ	Rabindranath
সোনিকা	Sonika
কিছুই	Nothing
সেটা	That
যোট	Jot
হক্ব	Hawkeye
রাষ্ট	State
ধোনবাদ	Vandalism
কালচার	Culture
বাড়াবাড়ি	Excesses
করিলে	If you do
স্বাধীনতাবিরোধী	Anti-independence
তত	So much
হুজুরকে	To the Lord.
লক্ষ	Lakhs
স্বাধীন	Independent
মুসল	Mosle
ফল	Result
ধুদের	The dust
কেটে	Cut
ভাইদের	Brothers
১নংবার	No. 1 time
মানুস	Manus
দাও	Give
৯৬	- 96
সবাইকে	Everyone.
নাস্তিকের	Atheists
ইউটিউব	YouTube
ভায়েরা	Brothers
চুইদা	Chuida
ডুকালে	Ducal
সাথে	With
৬৫	- 65
আজ	Today
বিকেলে	In the afternoon
পুরস্কার	Award
বড়	Large
মালুরা	Malura
করতে	To work
রাইতো	Raito
চুদবেন্না	
চোদ	
পরুক	Wear
বিকল্প	Options
দেয়ার	Giving
আবার	Again
যোগ্যতা	Qualifications
কেনো	Why?
ধুয়ে	Washed
শোরের	Shore's
দিছিলো	It was
কাজটা	The work
লাখ	Lakhs
জন	John
দাঁড়িয়ে	Standing
সরাসরি	Directly
কৃষ্ণের	Krishna's
ফায়দা	Benefits
আইছোতো	Aichoto
শেষেরটা	The last one
ময়লা	Dirt
পাশে	Next to
মেয়ে	Daughter
৭	- 7
পাকি	
মারামারি	Fights
শেমজা	Shemza
এখনো	Still
সম্পাদক	Editor
আমেরিকা	America
বাদে	Except
পতিতার	Prostitutes
বয়সে	Age
বিসর্জন	Abandonment
জাহান্নামে	In Hell
চাপ	Pressure
মারব	I'll kill
হার্টফেল	Hartfel
চারালের	Charal
দায়িত্ব	Responsibilities
দালালের	The broker
পর্যন্ত	Until
একতা	Unity
মাগী	Magi
উদ্দেশ্যে	For
বন্ধ	Close
বিবেকে	In conscience
স্যার	Sir
পুনরায়	Again
শিখ্যনিয়	Learning
খুবই	Very
সন্তানের	Child
পায়ন	Payne
খাটাশ	Khatash
দিসে	Disse
খুজো	Khojo
সাউন্ড	Sound
বোকা	Stupid
ক্যারে	Carey
কামর	Bite
আইয়ুব	Ayub
ভোলার	Forget
অনুযায়ী	By
এখনই	Now
৭২টি	- 72
চেয়ে	Than
৪০	- 40
রস	Ross
গূদে	Gooey
ইস্টপিট	Eastpit
হারলি	Hurley
পাইবি	Pibby
চিরঋণী	Forever indebted
একমাত্র	Only
দেখা	Seen
পুরুষরা	Men
করব	Will do
গুন্ডা	Goons
কাভি	Kavi
হইয়া	It's
চুতমারানি	Chutzpah
ভইরা	Voira
ছাএলীগ	Umbrella League
চিন্তা	Think
টাকার	Money
প্রতিটি	Each
জামাই	Son in Law
যত	As
নিছিস	Take it
কারনেই	For reasons
বেয়াদবের	Nonsense
উন্নত	Advanced
সুফল	Benefits
মানতে	To admit
পাডার	Pastor
মাথা	Head
শেষমেশ	Finally.
রকম	Like
খাওয়াস	Feed
অংশ	Part
আরাম	Comfort
চা	Tea
খুনির	The killer
ন	No.
সতর্ক	Warn
শুয়োরগুলো	Pigs
অনুসারে	According to
কতবড	How many
সেনাবাহিনীর	The Army
ধন	Wealth
খুঁজে	Find
সনিকা	Sonica
বাসা	Home
যদি	If
মোললা	Molla
আওয়তায়	In aweta
আসিস	Come on
ধর্ষণ	Rape
জনো	Jono
তুইআবার	You again
চোদাতে	
এক	One
এবাভে	Ebave
গড়গড়	Average
ফেটে	Bursting
গুষ্টি	Bunch
তাম	I used to
পীর	Pir
মিলিয়ে	Together
সেই	The
৫	- 5
নাম্তিকদের	Namesaks
বিয়ের	Marriage
দেরকে	To whom
এটি	It
কারিগর	Artisans
খারাব	Kharab
রাপ্পিযং	Rappyzong
সবগুলার	All of them.
ওরে	Oh.
আরো	More
শিল্পীদেরকে	Artists
বিকাশের	Development
ওটা	That's it
এনে	And
লীগয়েই	In the league
ফাঁসানোর	To frame
সংসদে	In Parliament
তুলে	Picked up
হো	Ho
বিল্ডিং	Building
যুবগয়া	Yuvagaya
যউনাংগে	Yunangay
দশের	Ten of
চুদাই	
হালা	Hala
জাচ্ছে	It's
আসলেই	Really.
হয়েগেছে	It's done
আওয়ামী	Awami League
খুলছোস	Open it
নিকি	Nikki
টয়লেট	The toilet
তারপর	Then
খানকীর	Khankir
ভাড়ামী	The tenant
যতটুকু	As much as
তুমি	you
গিয়ে	Going
হবু	-- Hob
পেলাম	Got it
প্রাণ	Life
চাইল	Wanted
বাসন	Utensils
পরিণাম	Consequences
একমাএ	A single mother
পাইতাম	I got
চক্র	Cycle
বাচ্চা	Child
দায়িত্বটা	The responsibility
চুরকানি	Churkani
লাইভে	Live
চুদে	
প্রাংক	Prank
দিয়েছিলাম	I gave
বিতর	Bitar
চুদির	
স্টার	Star
মাদারচুত	
গুদ	
ভাগ্নে	Nephew
সেক্স	Sex
হিন্দু	Hindu
এইটাই	That's it
হুদাই	Hudai
কোনু	Konu
বুঝলেন	Got it.
বোন	Sister
ওপেন	Open
ইরান	Iran
দেও	Give it
কিছুতে	In some
সাজু	Saju
শামিম	Shamim
কাদাপানিতে	In muddy water
নামরত	Naming
দরদ	Pity
থাকবা	Stay
অগ্রগতি	Progress
গুনগান	Humming
মাহিরে	In Maher
আওয়ামিলীগ	Awami League
চুদছে	
দুনিয়ার	The world
উপস্হাপিকা	Presenter
লাগানো	Planted
কমিশনার	Commissioner
নবি	Prophet
স্টেট	State
দেশটাকে	To the country
ধরমো	Dharmo
সমাজ	Society
কারোর	Someone
শুকিয়ে	Drying
বঙ্গবন্ধু	Bangabandhu
সইতে	To endure
দিবো	I'll give
সরকারেই	In government
রাস্তা	Street
লোকের	People
বালি	Bali
ভাউ	Wow
বিশাস	Bishas
পুটকির	Putkir
এটাকে	It
চেয়েও	More than
পরিবারের	Family
দখলে	In possession
চুল	Hair
সত্তকে	Satake
লাওরার	Laura's
নোবেল	Nobel
জেত	Win
মাথায়	In the head
তোমাদের	You
এর	Of
মানে	I mean
কণ্ঠ	Voice
যায়	Goes
দুইটারেই	In both
তারাছিস	They are
মস্তান	Mastan
ছিলাম	I was
অনুষ্ঠান	Program
একলা	Alone
ফ্যামিলি	Family
উটছ	Camels
থাকতে	Be
এ	A
উপস্হাপক	Presenter
গান	Songs
গেদী	Geddy
বলি	I say
আওয়ামি	Awami
এটাকি	What about it?
পতিতালয়ের	Brothels
অারে	Oh
মিয়ানমারের	Burma
ঢাকাৰ	Of Dhaka
ইসব	That's all
কাউয়ার	Kauer
হাইরে	Hi
চোদার	
মাইনসের	Mines
সামাটাতে	In Samata
জাগায়	Wakes up
তেকে	Tekek
উন্নতি	Improve
দিল্লিতে	In Delhi
সমস্ত	All
বালতি	Buckets
গুদে	In the
ইনশাআল্লা	Inshallah
দুর	Far from
ভিডিও	Video
চাটতে	To lick
ঝামেলা	Trouble
কত্থা	How much
লম্পট	Lame
পাইলে	If you get it
তোরে	You
আলি	Ali
আসছিস	You're coming
ধরা	Catch
আয়েশা	Ayesha
রোধে	To prevent
জেচিকা	Zechika
মারো	Hit me
গুলা	
বিদেশিদের	Foreigners
জানোয়ার	Animals
৫৭	- 57
চোদী	
তোমাকে	To you
ওকে	Ok.
পুরোটাই	All of
প্রক্রিয়ায়	Process
ছাত্র	Student
প্রথমেই	First
বিএনপির	BNP
ঘষা	Rubbing
পতন	Fall
ঠানডা	Thanda
গুলার	Guller
গৌতম	Gautama
থাকতি	Stay
সাহেবের	Mr.
চুদি	
স্বৈরাচারীর	Autocrats
সড়যন্ত্রে	In the plot
সাধারণ	General
পিছনে	Back
পরিচয়	Identity
আর্টিস্ট	Artist
জনে	John
অভিনেত	Starring
রাজ্য	State
যাতে	So
মাত্র	Only
ছুরি	Knives
গোবরে	In dung
শিখ	Sikh
লাগে	It takes
বরে	The bride
মন্তীদের	Monty's
ফেস	Face
টেন	Ten
কোটি	Crore
বিশ্বে	World
নে	Ne
নাম্বার	Number
শুয়োরের	Pigs
পুরি	Puri
বোদার	Boda
ধর্ষণের	Rape
প্রচন্ড	Fierce
ফাক	FAK
ব্লাডি	Bloody
তারাতারি	Taratari
ফুটকির	Footnotes
নিজেও	Himself
ইন	In
সবাধীনতা	Subjugation
জে	J.
বাদ	Dropped
লাইন	Line
আবাসিক	Residential
পুলারা	Pulaira
চুদামি	
সন্মান	Respect
জিয়াউর	Ziaur
ষড়যন্ত্র	Conspiracy
অঞ্চলের	Zone
প্রয়োজন	Need
বালফালায়	In Balfala
জানাই	Let me know.
পানিতে	In water
থাকে	There is
শিক্ষিত	Educated
এরা	They
দিতেই	To give
দেখ	See
মিশাইয়া	Mishaya
চুধ	
চরিএ	Charia
জাগরেণ	Zagren
ধর্মই	Religion
পুত	Putt
লুইচ্চাগো	Luichago
মুসলিমদের	Muslims
মোক্তাদির	Moktadir
তারাও	They are also
নাস্তিক	Atheists
সোনার	Sonar
বস্তির	The slum
সেখানেই	There.
ছাডা	Shade
আরেকটা	Another
থাকছঐ	It's
বোনধু	Sister-in-law
বাচ্চু	Bachchu
বাজে	Bad
দাগ	Stains
অনুমতি	Permission
পেছনে	Behind
আজকে	Today
বর্তমান	Current
জারত	Jarrat
ছেলেগুলাও	The boys, too.
তাইতো	That's it.
জারা	Zara
নুনু	Nunu
চরিত্রহীন	Characterless
বাঞ্চত	Banchat
ছোলা	Chickpeas
হিজ্রা	Hijra
প্রার্থীর	Candidate
সুন্দর	Nice one
তুরে	Toure
মাতারি	Matari
যাঁরা	Those who
পিসলামিক	Pislamic
একসাতে	In unison
আবাল	Abal
কাপর	Cloth
দিছ	Given
বানানোর	To make
ক্ষিপ্ত	Angry
কোচি	Kochi
দখতে	Dakhte
মানুষে	In people.
রেন্ডিয়ার	Rendier
পেন্ডিয়ান	Pendian
রনি	Ronnie
যেটার	Which
মাসের	Month
মরবি	Will die
মাপের	Size
চুদার	
মানাই	Manai
গূতিয়ে	Gooeye
হয়েছে	Have been
বিজ্ঞানের	Science
ধুর	Damn it
চোখে	In the eyes
শরীরে	In the body
খানকির	Khankir
দেকে	Deke
মালায়ুন	Malayun
পজিসনে	In position
দলের	Group
রাষ্ট্র	Country
সেলিব্রিটিরা	Celebrities
সেনা	Army
অবৈধ	Invalid
চক্রান্তের	Conspiracy
শান্তি	Peace
বউ	Wife
চুদাছো	
ইয়াবা	Yaba
বলছে	Says
দিনের	Days
কথাবলানো	Talk
তুমিও	You too
বের	Eject
তৈরি	Create
পাগল	That's crazy
তরার	Tarar
বিষ	Poison
অঙ্গ	Component
করি	I do
ভয়	Fear
পুটকিতে	In putty
দেওয়াইতাম	I used to give
তোমাৰ	Yours
টিউন	Tune in
রাখবেন	Keep
সমর্থনে	In support
বদলি	Transfer
সালমান	Salman
চোদাই	
চুদবে	
চোদমারানির	
কাট	Cut
শাউয়াতে	In Shaua
দলীয়করণ	Partisanship
ব্যশ্যাস্যালয়ের	Of the Office
এইটার	It's
চুরের	Churr
সত্যিকারের	The real
হিন্দুরা	Hindus
মোবাইলের	Mobile
বন্দোবস্ত	Settlement
চাওয়াটা	The demand
ভারতকে	India
ডুবাই	Dive
যেতে	Go to
মুছে	Delete
বানায়	Makes it
এসে	Came
কুয়েত	Kuwait
কাকে	To whom
নেতার	Leader
ঘটেছে	Occurred
কান্দে	Kande
বানাতে	To make
দেহ	Body
জিয়া	Zia
মীর	Mir
হায়রে	Alas.
হক	Hoc
কনো	Kono
ঝারজ	Jharj
বারির	Bari
বংশধর	Descendants
লন্ডনে	In London
ভালবাসেন	Love it
মুখটা	The face
ঠিকই	That's right.
দেয়াইস	Deweys
সালায়	Salay
মোল্লাদের	Mullahs
তবেই	Only then
ভোলা	Forget
ভাত	Rice
হেদায়েত	Guidance
মাদকমুক্ত	Drug-free
একটু	A little
সাক্ষি	Witnesses
হিসেবে	As
২য়	2nd
বুঝিস	You get it.
মেটাতে	On Meta
ইংলিশেই	In English
এবং	And
হইলেই	If so
দেখাই	Show me
চালাচ্ছে	Running
ভাষায়	Language
গ্রহণ	Accept
স্থান	Space
ঢুকাতে	To insert
সিলেটে	In Sylhet
মুসলি	Mosley
বানর	Monkeys
নষ্ট	Wasted
ধোলাই	Washing
বন্ধু	Friend
করতেও	To do
ইজ্জত	Honor
বাধবে	Will
জনগণকে	To the people.
বানা	Bana
চলো	Come on
বেঈমানকে	Dishonesty
আলী	Ali
শেষের	End
তা	It
লাগাইয়া	Put on
মত	Like
দেওয়ার	To
পোলাগো	Polago
করলেও	Even though
পাও	Get it
এরো	Aero
ওই	That
পাবে	Will get
সার্বজনীন	Public
মায়ের	Mother
একবার	One time
খাইজ	Khaiz
করতেছে	It's
অধিকার	Rights
সৌভিক	Souvik
কনডোমের	Condoms
এক্টিং	Acting
কাংলাদেশী	Bangladeshi
করেন	Done
চুলকানী	Itchy
বিনিওগ	Biniog
নিজের	Your
সিইসির	CEC
চোদবো	
মায়ানমারের	Of Myanmar
গাড়	Ass
আড়া	Hide and seek
লাত্থি	Latthi
ধইরা	Dhaira
মাদারিচোদ	Madarichod
করছিলো	It did
নাছিরের	Nasir's
পুরা	The whole
বো	Bo
দিনগুলো	Days
অনকে	Onk
সংলাপ	Dialog
আওয়ামিলীগকে	Awami League
নডি	Noddy
পুরুষ	Man
চেয়েছিল	He wanted
ভাগের	Basher
নেবে	Will take
চারা	Seedlings
উদ্যোগ	Initiative
পারেন	Can
বুঝবে	Will understand
আরবে	In Arabia
জবান	Statements
হালারা	Halara
প্রস্তুতি	Preparation
পরবর্তী	Next
ডি	D
জন্মে	Born
চাটা	Licking
বাইরে	Outside
ঝোকে	Zuke
মাহির	Maher
সাধারন	General
লাফালাফি	Jumping
নাই	Not
ন্যাংটা	Nangta
খাচ্চর	Mules
হত্যার	Murder
কৌশলগত	Strategic
চোর	Thieves
ইউ	You
ভোট	Vote
হায়	Alas.
তাকে	To him
বাজারের	The market
বেশ্যাবৃত্তি	Prostitution
দিছি	I'll give
জেহাদি	Jihadists
উফ	Oops
থাকল	Stayed
বাসিন্দা	Residents
পায়না	Don't get
আওয়ামীলীগ	Awami League
আগামী	The next
লড়াই	Fighting
অপমানিত	Insulted
দাম	Price
বেহায়া	Nonsense
মাকে	Mother
যতেস্ট	Jatest
মেকাপ	Makeup
দেখাইয়া	Show
দাদার	Grandfather's
কাজ	Work
মিলা	Mila
বাদী	Plaintiff
মান্নার	Mannar
খৃষ্টান	Christian
তামাশা	Joke
বাচ্চার	Child
ভোদের	Voder
বিরোধী	Against
বাবা	Father
আখি	Akhi
চুদান	
ছাই	Damn it
দেখো	Watch it
সূচি	Index
শহীদ	Martyrs
দিছে	It's
উঠতো	It was up
ভাপ্তেও	Steamy too
নির্বাচিত	Selected
বা	Or
মিউজিক	Music
ঘর	Cell
মাদার	Mother
মহাপাপ	Great sin
পারলে	If you can
ভোটে	Voting
পরিচয়	Identity
গু	Goo
খোদ	Itself
দে	De
রেখেছে	Has
দম	Suffocation
বাস্তবায়ন	Implementation
লাগেনা	It doesn't take
প্রস্তাবগুলো	Proposals
রাখাইন	Rakhine
সিলোনা	Silona
১৮	- 18
যা	That
দেয়ের	Deir
মাইর	Mair
চোদন	
খায়	Eats
ফাকিস্তানী	Fakistani
২৫	- 25
ভালা	Well,
দূরে	Far away
শুওরের	Pigs
শিট	Sheet
মুখে	In the face
বিবশ্র	Disambiguation
কোথায়	Where is
দেখলে	See
দীঘা	Digha
নিজস্ব	Own
মুসলমানের	Muslims
জারি	Issued
প্রিয়	Dear
ঘৃণা	Hate
বাডে	Bade
অর্থনীতির	Economy
তোমরা	You
নির্ভর	Depending on
স্বরূপ	Example
বুজতি	Understanding
গ	c
জাহান্নামের	Hell
এগুলা	These
তাড়াচ্ছে	Chasing
এতই	That's all.
জানার	To know
বেটাই	Betai
ডংশ	Dongsh
ফরিদপুরের	Faridpur
সত্তিকারের	Sathikar
ইহুদীকে	To the Jews
উদ্বোধনের	Opening
এইডা	Aida
দালল	Dalal
চিলো	Chillo
কেমতে	How about
করতেসিস	Corysis
শান্তির	Peace
আচরণে	In behavior
পালন	Observance
সম্ভাবনা	Possibilities
স্বচ্ছ	Transparent
পথ	Path
বাসটেট	Bastet
দীয়ে	Diye
থাবড়াইতে	In thrust
পরিনত	Turned out
অশান্তির	Unrest
মার্কায়	In mark
বাহাবা	Bahaba
প্রক্রিয়া	Process
দেবে	Will
মান্নাভাইকে	To Mannabhai
ডুবে	Drowning
বাল্যবিবাহ	Child marriage
ধান্ধা	Hypocrisy
মায়রে	Myre
ইসরাইলের	Israel
পুতের	Putre
আসেই	It comes
দাউ	Dau
ভালোই	Well done.
চাই	Want
চুলকায়	Itchy
মানসিক	Mental
অপবাদ	Slander
পাকনা	Don't
ধরে	For
হোসেন	Hossein
নুডিরা	Nudira
কন	Con
গার্লফ্রেন্ড	Girlfriend
আদর্শে	Ideally
কারন	Because
ধরি	Let's say
সেক্সে	In sex
হাটে	In the market
এই	This
নাটকের	Drama
অটো	Otto
নিয়ে	With
মাদারির	Madari
পুরোপুরি	Exactly
টিপে	Press
নিজেকে	Yourself
পোদেৰ	Podder
অাসলে	Asley
আইনের	Legal
নূর	Nur
করে	By doing
ঠেলে	Pushed
নৌকা	Boat
ব্যসালয়ে	In business
সীমানা	Boundaries
এইটা	This is
বাঁশদিয়া	Bansdiya
করা	Done
পাবলিকের	Of the public
উদ্ধে	Quote
সারা	Whole
ফিরে	Return to
নাসরিনের	Nasreen
রাত	Night
হাঁস	Ducks
পরপুরুষের	Of the alien
স্টাইল	Style
নি	Could not
দেছ	Give it
সো	So
চুবৌ	Chubou
হাফ	Half
নিরজাত	Nirjat
বেয়াদব	Nonsense
পেয়েছো	Got it
খানকিমাগির	Khankimagir
খাদেম	Khadem
হিন্দুদের	Hindus
নতুন	New
বেদব	Vedab
পড়েছে	Read
আমারা	Us
জম্ম	Birth
২	- 2
পর	After
বসে	Sitting
মইনুল	Moinul
চামচামি	Spoonfulness
কিরে	Kire
ফেলবে	Will
তুরা	Tura
বাঙালির	Bengalis
মাগিরা	Maghira
ফাজিল	Fazil
টোর	Tor
খালি	Empty
মুচেফেলা	Deletion
বেরকরে	Out
লেখে	Writing
রাস্তাই	The road
হয়েছিলেন	Became
ধর্ম	Religion
মিয়ারমার	Mearmer
মাঘা	Magha
পাচ্ছেন	Get it
কুমারী	Virgin
দেশ	Country
হারামজাদা	Haramzada
ইনচি	Inchi
ব্যান্ড	Band
মেটাতো	Metato
তালা	Lock
পলিটিশিয়ান	Politician
মামা	Mama
খ্রিষ্টানদের	Christians
শ্রেষ্ঠ	Best
গর্ব	Pride
কনটেন্ট	Content
যারে	Who
মাইরে	Myre
বিশ্বাসী	Believers
নয়	Not
চিহারা	Chihara
পড়ল	Read
মাছুদা	Machuda
পাচায়	Pacha
বাধ্য	Obliged
ৱা	Wow
জনাব	Mr.
জন্যা	For
হতেই	To be
বাংলাদেশকে	Bangladesh
ছেলেরা	Boys
লাত্তি	Latti
কীট	Insects
বাংলাদেশের	Bangladesh
ব্যাখ্যা	Explained
আল্লাহই	God.
অধীনে	Under
সেজে	Dressed up
ছৌঃ	So:
বিরু	Biru
শূয়োর	Pigs
কুতার	Kutar
শালিরে	Shalire
শুধু	Only
ধোনটা	The drum
অধপতনে	In decline
নেতারা	Leaders
সোনিকার	Sonika
টাইপের	Type
পাবনার	Pabna
দরজা	The door
চুদ	
হি	Hee
হিন্দুর	Hindus
আছিলা	It's
করলি	It did
করবো	I will
বাড়িয়ে	Increased
ভুতে	Ghosts
সরকারের	Government
মোসলিমের	Moslem
দেন	Given
তোরাই	You
চোদলে	
করলে	If you do
রহমানের	Rahman
অথচ	But
পুতকেতো	Putketo
কাদিয়ানীর	Qadiani
শব্দ	Sound
সময়	Time
হিটলার	Hitler
বলেছে	Said
দিকি	Diki
গরম	Hot
সংবিধান	Constitution
জন্যি	For
বসছে	Sitting
বরবাদ	Vandalism
গর্দভ	Gordov
আপনার	Your
লক্ষ্য	Target
হচ্ছে	It's
রেন্ডির	Randy's
বোকাচুদা	Stupidity
গরু	Cattle
পতিতা	Prostitute
আসার	Coming
ত্যাগ	Sacrifice
বলছিস	You say
মুরগি	Chicken
যোগ্য	Only
মাগীর	Magyar
পৃথিবীতে	World
ভাদা	Vada
চোদাবো	
সুষ্ঠ	Fair
পি	P
মেরে	Killed
করবেন	Do
বাদি	Badi
মোদী	Modi
সাবান	Soap
টাইটেল	Title
দিলে	If given
বঙ্গবন্ধুর	Bangabandhu
হত্যা	Killing
ইংলিশ	English
যাকে	Called
ঐক্যবদ্ধ	United
পিটানো	Beating
এটা	It is
চুদছি	
সংগীতকে	Music
মালাউন	Maloon
দেখাবি	Show me
নেতা	Leader
পাছার	Ass
বললে	Said
মুখের	The face
কারোন	Karon
সুনান	Sunan
কুফিয়ে	Kufiye
কোন	A
ঐক্যটাকে	To unity
পাকিস্তানের	Pakistan
নিয়োগ	Recruitment
কথাও	Talk
হয়েছেন	Done
গুরু	Guru
চ্যাম্পিয়ন	Champion
ফেমিলি	Family
রাখলি	Keep
অন্যের	Others
যান	Go
সমাধান	Solution
রাখে	Keep
নেওয়ার	Taking
মালউন	Maloon
এখানে	Over here
ফোন	Phone
মারাও	Kill
সচিবের	The Secretary
আম্পায়রে	Umpire
নাগা	Nagas
একদলের	A group of
লাগলো৷	It felt.
দুর্গা	Durga
যিনি	Who
জানলাম	I found out.
নিশ্চয়	Of course.
গত	Last
কাদার	Mud
পৃথিবীর	World
গড়া	Created
কন্ড়ম	Kannada
ভিজা	Wet
পাকিস্তানকে	To Pakistan
মেয়েটার	The girl
বলে	Says
বল	Ball
আওয়ামীলীগ	Awami League
ধন্যবাদ	Thank you
কর্মের	Action
প্রার্থী	Candidates
ঘীনা	Ghina
বোঝার	Understanding
দিয়ে	With
লগে	Log
বলেছিস	You said
বেইশ্যা	Beishya
ব্যাস্ত	Busy
কাটমোল্লাদের	The Cutmollas
দেবার	Giving
আপু	Apu
মাসে	In
দেখব	I'll see.
হাজব্যান্ডের	Husband's
স্বাভাবিক	Normal
ভর্তি	Admission
সকল	All
ঐক্য	Unity
সুবিধাবাদি	Opportunists
যায়কিনা	Zaykina
জন্মগ্রহন	Born
কন্টেন্ট	Content
শিল্পীর	The artist
তাকিয়ে	Looking at
বদলাস	Change
কমে	Reduced
জনগনকে	To the people.
বৈকল্য	Disability
গোরে	Gore
পারতি	Perhaps
সরকারে	In government
পাওয়া	Found
করস	Do it
বাংগালি	Bengali
ছিড়ে	Torn
কাঁটা	Thorns
বুদায়	Buda
কাইল্লা	Kayla
ওপর	On
সালিরা	Salira
পারস	Paras
হলে	When
কিভাবে	How come
সরম	Saram
করলো	Did
মাদারি	Madari
নটি	Nine
দেখছেনা	Don't see
মাইয়ারে	Meyer
ছাগলের	Goats
খায়াপ	Khayap
আচ্ছা	Well.
খুব	Very much
এসিট	Acetate
তারা	They are
জেহাদির	Jihadists
লোপা	Lopa
সবকিছুর	Everything
আভিনয়	Avinai
মিলী	Millie
দাশিকে	To Dashi
পড়লে	If you read
দিচ্ছে	Is
হিন্দুদেরকে	Hindus
আবলামু	Ablamu
খোর	Khor
নামক	Named
বাইঞ্চুদের	The Bainchus
গুনে	Counting
শালা	Brother in Law
মাইরা	Myra
নিজেগো	Itself
সাহেব	Mr.
৯	- 9
মাঙ্গি	Mangi
আলাপ	Chat
ফাটিয়ে	Cracking
হত্যায়	In murder
পড়ে	Reading
কাছেও	Even close
রোজগার	Income
কোনো	No
বেহেস্ত	Paradise
স্বীকার	Accept
রেমিটেন্স	Remittances
বালের	Baal
মারতে	To kill
জাফর	Jafar
মহিলাদের	Women
বিক্রি	Sales
ইন্টারভিউ	Interview
পিটাতে	To beat
ভাবছিস	You're thinking
সিনহাকে	Sinha
মিথ্যাবাদী	Liar
সাইন্ড	Sound
ভয়ংকর	Terrible
লাগায়ে	Instead
কবর	Grave
কে	Who?
বিশেষ	Special
শহিদ	Martyrs
গালমারানিরিরা	Galmaranians
মা	Mother
মালাউনদের	The Maloons
মাজার	Shrine
ব্যাটার	Batter
হত্যাকাণ্ডে	In murder
ইত্রামি	Itrami
মেম্বার	Member
নাকী	Naki
বাইড়ানি	Bairani
ছাড়া	Take off
তাতে	In
দেখাইও	Show me
প্রধানমন্ত্রীত্ব	Prime Ministership
সার্থপর	After the
সেলিব্রিটি	Celebrity
কাটা	Cut
ভারতের	India
বংধর	Bangdhar
বোনকে	To my sister.
পোলারা	Polara
কয়	How much
নিজেই	Itself
শুকারের	Pigs
অনলাইন	Online
যাবই	I'll go
ব্যাংক	Bank
থেকেও	From
বেশ্যের	Of prostitution
আয়েশাকে	To Ayesha
রিপোর্ট	Report
গণতান্ত্রিক	Democratic
ব্যক্তিদের	People
বাজ	Buzz
খান্কির	Khankir
জাকের	Zaker
মানুষের	Human
হাত	Hands
পাব	I'll get
বলেই	That's why
প্রচলিত	Are
বিডি	BD
মোবাইল	Mobile
আন্দালিব	Andalib
মর্যাদার	Dignity
মরলেও	Even if you die
চেটের	Chet
ওরশ	Orsh
বোধা	Bodha
মুক্তোর	Pearls
ছোটি	Small
নেহেরু	Nehru
পূলিশের	Polish
হযরত	Hazrat
নাকেয়	Nose
ব্রা	Bras
রিদিয়া	Ridia
দুশমন	Enemies
চুদমি	
পো	Po
বলিস	Say
বিরুদ্ধে	Against
বংগ	Bong
কামালের	Kamal's
লুচ্চামি	Luchami
খাম্বা	Khamba
তারিয়ে	Tarye
মমতার	Mamata
আস	Come on
বন্দীদের	Prisoners
আস্তিক	Atheists
নীতিমালা	Policy
পাকিস্তান	Pakistan
পরের	Next
সন্তানে	In children
গেলো	Gone
প্রভু	Lord
নওয়াবজাদা	Nawabzada
কেমনে	How about
এইটুকু	That's it.
বিশাল	Huge
প্রশ্নকর্তা	Questioner
হাসপাতাল	Hospital
অাওয়ামিলীগ	Awami League
আটি	Ati
তরে	Tore
রোগীর	Patients
ফ্রন্ট	Front
করছিস	You do
বাতিল	Cancel
কর্তব্য	Duties
মাহি	Mahi
হনুমান	Hanuman
ভুলে	Forget
লাগত	It felt like
খেয়ে	Eating
তুমাকে	To you
মালের	Mal
অনুষ্ঠানে	At the event
গঠন	Structure
জালা	Nets
নাক	Nose
থাকতনা	There was no
ছি	I
রোস্ট	Roast
পরিচালনা	Operation
শুনে	Listen
তাইলে	So.
যোদ্ধা	Warriors
মানুষিকতার	Humanity
ভেড়া	Sheep
চুদবেনা	Don't
বলাতে	In saying
পারেননি	Could not
হারামি	Harami
বলবেনা	Don't say
বাড়ী	Home
সাজানো	Sorted
মুজিব	Mujib
পাডা	Pada
তার	His
দয়া	Please
কুলে	Cooley
চোদরে	
কাইটা	Kaita
আদর্শের	Of ideology
ঢুকে	Enter
ফেললে	If
তকে	Toke
ভাব	Thoughts
চুদনাপানা	
গাইছে	Singing
একরাত	One night
মসুলমান	Mosulman
খেয়ে	Eating
চোদাইন্না	
চিল্লাই	Chillai
সুযোগে	By chance
৩০০	300
ভাঙনের	Breakdown
করবা	Do it
ফহিন্নিরে	Fahinire
যেকোনো	Any
নম্বা	No.
হাহাহ	Hahaha
ইহুদিকে	To the Jew
তথা	
হয়েছে	Have been
আসুন	Come on
জ্ঞান	Knowledge
পলিটিকাল	Political
ব্যাক্তিত্ব	Personality
সাপরোর্ট	Saprot
জুতার	Shoes
লাথি	Kicking
মিথ্যা	Lies
প্রবাসীরাও	Expatriates
রিয়েল	Real
রে	Ray
হান্দু	Handu
রাজনৈতিক	Political
আইসা	Aisa
বক্তব্যে	In speech
ঠাকুর	Tagore
পাইয়া	Get it
প্র্যাঙ্ক	Prank
নারীর	Women
মন	Mind
জয়ের	Winning
আই	I
কনডম	Condoms
পান্ডা	Pandas
ভবিষতে	In the future
সম্ভব	Possible
ভাববে	Think
বলছিল	It said
মুসলিমরাই	Muslims
মাথাল	Head
উচিৎ	Should
শুটকির	Schutzky
সেনাদের	Soldiers
মুনাফেক	Hypocrites
দাঁড়াতে	To stand
হোগায়	Hogay
খাড়া	Steep
ফিতা	Ribbons
ফকিন্নি	Fakini
তোদের	You
জাতি	Nation
কুরান	The Qur'an
এভাবে	As
আমি	I
ধোন	Dhoon
মোসসলমান	Moslem
রহমান	Rahman
মানা	Mana
প্রজ্ঞাপন	Notification
বেডির	Bede's
চেহারা	Appearance
যাই	Let's go
নাটক	Drama
পেলছে	Got it
বাল	Bal
করানো	Is
মারলেও	Even if you kill
সবার	Everyone
নস্ট	Nost
নাগাল	Reach
বসিয়ে	By sitting
চাটতি	Flattery
মাতাল	Drunk
ভাইয়া	Brother
হাসিনা	Hasina
সুন্দ	Sunda
বাঙালি	Bengali
কুততা	Hypocrisy
করায়	Done
পেটা	PETA
লড়াই	Fighting
টাউট	Tout
বাটপার	Butpar
শুয়োরছানা	Pigs
ওয়াশ	Wash
চিছ	Cheesy
ভারতীয়রা	Indians
মেম্বারের	Member
বছরের	Year
চিকা	Chika
আসেনি	It didn't
সব	All
বি	B
ছিড়েছে	Torn
ফাকিস্তানের	Of Falkistan
পরেছে	Worn
নাফর্মান	Naforman
মাইরি	Mairi
কর	Tax
একেবারে	Absolutely
বেশ্যা	
সাধীনতা	Subjectivity
স্বৈরাচার	Dictatorship
পাওয়া	Found
এজেন্ট	Agent
দুর্গন্ধময়	Stinking
বিতরে	Bitare
অফ	Of
গুলারে	Gulare
টুকরা	Pieces
ফহিন্নি	Fahinni
একাউন্ট	Account
হেই	Hey.
ব্যবসায়	Business
উচ্চারন	Pronunciation
চটি	Chutty
লাগতেছে	It feels like
মিথ্যে	Lies
লাগলো	It felt
চাইলে	If you want
কর্মকর্তা	Officers
মোহাম্মদ	Mohammad
বানাস	Banas
মনেহয়না	I don't think so.
পার্থক্য	Difference
রং	Color
ইয়াজিদের	Yazids
করতাম	I did.
ধরো	Hold it
এগুলারে	Here's the
মাঘীর	Maghir
হয়েগেছে	It's done
গেলে	If you go
রেট	Rate
যোনি	Vagina
জামা	Clothes
এত	So much
পর্যায়ে	Stage
বুঝে	Get it.
বাডি	Buddy
পারেনা	Cannot
শালী	Shali
গলা	Throat
সংসারী	Family
পেচে	Peche
আটকে	Stuck
চুদমু	will fuck
চোদাচুদির	fuck
চুদাচ্ছে	fucking
চুদলে	fuck
চোদনা	fucker
চোদামু	will fuck
চুদাইতেছে	fucking
চুদায়	fuck
পিষ্যা	whore
চুদী	fucker
গুদের	vagina
চোদাও	fuck
পর্ণ	porn
চুদেই	fuck
মাদারচুদেরে	mother-fucker
চুদা	fuck
চুদারা	fuck
চোদাইতে	fuck
গ্যাংব্যাং	gangbang
চোদরা	fuck
তর	your
চুদমো	will fuck
চোধুরী	fuck
চুদের	fuck
চুদল	fuck
মাদারচোদ	mother-fucker
চুদাবো	fuck
চোদা	fuck
চুদেছে	fuck
চুদবেন্না	fuck
চোদ	fuck
পাকি	pakistani
চোদাতে	fuck
চুদাই	fuck
চুদে	fuck
চুদির	fuck
মাদারচুত	mother-fucker
গুদ	vagina
চুদছে	fucking
চোদার	fuck
চোদী	fuck
চুদি	fuck
চুদামি	fuck
চুধ	fuck
চুদার	fuck
চুদাছো	fuck
চোদাই	fuck
চুদবে	fuck
চোদমারানির	fucker
চোদবো	fuck
চুদান	fuck
চোদন	fuck
চুদ	fuck
চোদলে	fuck
চোদাবো	fuck
চুদছি	fuck
চুদমি	fuck
চোদরে	fuck
চুদনাপানা	fuck
চোদাইন্না	fuck
বেশ্যা	whore