असलामवेल्कम	AslamWelcome
ढोलो	Dholo
नैमहिद	Namhid
सेक्स	sex
डेस	Des
ज्द्रक्वुलाहु	Zdrakvulahu
भाजपा	BJP
खरीदते	Buy
विरोधी	opponent
बॉस	boss
हाहाहा	Hahaha
भोकने	Bhokne
लगेगा	Take
दिलदार	affectionate
प्रिंसिपल	principal of a college
ज़ाकिर	Zakir
पाडकर	Padkar
ईईक	Eik
टिंका	Tinka
मेलुंगा	Melunga
आत्मा	soul
गावोन	Village
उन्के	Their
विरोड	Virod
गा	Indicates future tense singular masculine
नीता	Nita
अपुन	Apun
घोडे	Horse
कफुज	Kafuz
वार्टलाप	Conversation
लेक	Lake
आत्याचार	Atrocities
ओकय	Okya
पैसा	The money
नुक्सान	disadvantage
हामने	We are
ब्यूटी	Beauty
उठायेगा	Will pick it up
जाके	Go
उठाये	Taken
लवली	Lovely
ओसामा	Osama
अनपध	Uneducated
जायेगे	Will go
खालुंगा	I will eat
किसिस	Kisis
जिम्मदारे	Responsibilities
सक्स	Sax
सुपरमैन	superman
जोड़ी	couple
अंट	Ant
डे	De
गली	lane
छोड़ते	Leave
ममी	an embalmed body
अदायें	Payments
बादशाह	king
भजान	Hymns
कायदा	formula
हुट	Hut
नुनीई	Nunii
पीट	kick
फरियाद	compliant
लागोस	Lagos
शाफ	Shaff
लायेगे	Will bring
चमचा	big spoon
हिले	Hile
ब्रबड	Brewed
डब्बी	Box
प	The twenty-first consonant of the devanagari syllabary
करवाकर	Get it done
गील्ली	Gilli
राठौर	Rathore
षड्यंत्रा	Conspiracy
सांस्डों	MPs
पपल	Papal
यादव	descendant of Yadus
प्रवचंबाबा	Father of the Prophet
केरेंगे	Will do it
विचो	Vicho
कातिलो	Katilo
सईद	Saeed
पड़ने	Falling
भूमत	Bhoomat
से	from
मुझसे	from me
ओप्चारिक्ता	Vacancy
मकसूद	Maqsood
पाण्डे	Pandey
शहीददिवस	Martyr's Day
जहानामी	Jahanami
स्छा	Good
एज्ज़त	Respect
पोपट	Pork
क्रवाओ	Get it done
चर्च	Church
हडल	Huddle
मुफखोरी	Freebies
खाश	Khash
गंभीर	deep
बनानाय	Make it
पत्थर	stone
इसना	This is
पाकी	
देसी	native
छोटा	little
शांति	peace
एड	ed
राब	treacle
कल्पना	imagination
उताकर	Utakar
चलक	Driver
डख्गी	Dakhgi
सैलरी	Salary
फाति	Fati
शिखर	apex
यययाय्ययय	Yayayyayya
सालो	Years
खुब	Very good
नुक्सान्दायक	Harmful
बेजजती	Indignity
फुस्सस्स	Whispers
अप्कू	Apku
पाड	Pad
हीरे	Diamond
वैया	Vaiya
वे	they
हहहाह	Hahahah
प्रणम	Salutations
बैइथ	Beth
हंसम	Hansam
जवाद	Jawad
थप्पद	Slap
माकन	Maken
दलले	Put in
टो	Tow
दातों	Teeth
व्हिस्की	whiskey
रेडी	Ready
समीर	breeze
बनाकर	By making
जामीन	Bail
तमन्ना	desire
दुनिया	world
अंदर	inside
अपसे	From you
कर्तव्य	duty
कांत	lovely
बना	compose
देखु	Let's see
एरी	Eri
नॉट	Not
पकड़ते	Catch
घुम	Walk around
अहम	vital
बालो	Balo
आइओ	IO
शोली	Sholi
पढ़ाई	reading
अल्लाहा	Allah
मिलो	Meet
चोरो	Thieves
मेनू	menu
जीवित	living
मुर	Mur
नालिया	Naliya
बॉल	Ball
सीओ	CO
चैन	Chain
हराम	unlawful
हव	Hava
चीज	thing
यीए	Yea
रखा	Placed
अवो	Avo
सोय	Soy
किउ	Why
सिगरेट	Cigarette
ताजा	fresh
ट्राह	Trah
हंसराज	Hansraj
जिससे	from whom
इत्ताना	It's
बेहेन	Behen
खुच	Something
आप्थो	Optho
राहुल	Rahul
जेटली	Jaitley
व्राय	Wray
तुउउ	Tuu
खोइश	Khoish
पे	on
ज्रूरी	Necessary
रेप्ली	Repley
आप्सी	Apsi
कोम्येडियन	Comedian
खुलता	Open
मेंहन	Mehan
केलोगो	Logo
र्ह्मत	
तारकी	Tarki
सातम्भ	Satambh
चुटियून	Chutiyun
करताय	Doing it
बढ़ाया	Enhanced
मंगलसेनाचा	Mars Army
फिलहल	At the moment
पहन	Wear
ट्यूब	tube
सबमे	All in all
पाकिस्तानियो	Pakistanis
बाजेन	Bajen
मोरालिटी	Morality
तकिये	Cushions
धन्यवाद	Thank you
आहुहुहु	Ahuhu
पाइर	Pier
गर	if used in poetry
शमा	candle
तुकडा	Piece
रोहितशार्मा	Rohit Sharma
नेकी	good
लिखाई	writing
लेफ्ट	left
पीने	Drinking
बिजिली	Bijili
जीसा	Jisa
कार्डेंगे	Cards
एसके	Sk
शिक्षा	teaching
मंगवाईगी	Will you order
डेखये	See
गुप्ता	A married woman who withdraws from her husband’s endearment
सेहत	health
भगोडे	Fugitives
मारताय	Killing
शाह	king
तुहाड़ी	Your
खुजलीवाले	Itchy
जावेगी	Will go
भोलो	Bholo
धुनयी	Dhunai
पिट	Pitt
परफेक्ट	Perfect
जुलम	Oppression
हम्मरे	Ours
केटा	Keta
होम	sacrifice
हिम्मतवाला	The courageous
क्ल	Clamps
धड़कन	palpitation
अन्याय	injustice
कपरा	Kapra
हाआआआ	Haaaaaa
रामजन	Ramadan
फोरेंज	Forrange
उस्को	Usko
उष्क्या	Heat
ओर्रर	Orrar
गन्दा	untidy
पापनिस	Papnis
ज्ञा	Knowledge
खुश	happy
बैग	Bag
हो	be
ज्ञाब	Known
मुक्य	Mukya
धनुष	bow
वाला	keeper
कुब	Kub
अत्याचार	outrage
तम	darkness
अहाना	Ahana
चौकआ	Square
बाजी	elder sister
अंग्रेजो	The British
करफिया	Karfia
क्मो	CMO
डिमांड	demand
अक्तर	Aktar
स्टोरीय	Story
गुमते	Missing
जमाना	to freeze
मिलना	to mingle
मिल	mill
बोला	Speak up
दीदी	elder sister
ताज़ा	fresh
हरमी	Harmi
जॉन	John
मायबे	Maybe
वालाइकुम	Valaikum
आधार	base
देदो	Give it
डेको	Deco
दुण्डे	Dund
आप्कोरेचार्ज	Your recharge
समस्या	problem
बेहद	boundless
सुकराना	Sukrana
क्रच	Crutch
आइटम	item
इनर	Inner
काड़े	Stick
मृत	dead
पगलपन्ति	Madness
दुर्घटना	accident
गणेह	Ganeh
ब्कवास	Nonsense
फैलने	Spreading
ज्स्को	JSCO
लॉ	law
लडके	Boys
फिनली	Finley
बजाता	Plays
माशा	A weight equal to 8 rattis
सकेंगे	Can be
रपी	Rp
माजे	My
आइक	Ike
डर्गप्रधान	Dargpradhan
दीखे	Look at it
उम	Um
बौत	Bat
मुजेह	Me
खाने	Eat
चाहिये	want
भक्ट	Bhat
लाग्न	Engaged
यूजना	Use
किदार	Kidar
आउ	span of life
अवि	the sun
होगाये	It will happen.
मेहनत	labour
औ	The eleventh vowel of the Devanagari syllabary
इन्हे	They
प्रभानसु	Prabhansu
परेशन	Trouble
जाए	Go
पध्ती	Method
सल्लुभाई	Sallubhai
काहटी	Where
जोड़	joint
बजेगे	Will be
सी	c
आता	coming
व्यावस्था	System
हिई	Hi,
रीच	Reach
हसना	laugh
समझने	Understand
ताभ	
पयेंगाए	Will you get it?
कौंसी	Which one?
पाधा	tutor
मुर्शीद	Murshid
चित्रा	piebald cow
घरेलु	Domestic
मोती	pearl
नामस्टी	Namasty
अट्टी	Hank or skein of thread
अकल	not in parts
कामया	Kamya
अमनातुल्लाह	Amanatullah,
पीके	Pk
ऑन	On
अच्छे	Good
मस्तरवा	Mastarva
नायफ	Naif
बहादुरी	bravery
देखओ	Look
चुक्कर	Chukkar
दौड़ते	Running
खूबसुर्त	Beautiful
विड	Vid
खुजलीवाल	Itching
माथ	forehead
दुस्मन	Enemies
क्रुन	Cróon
रो	weep
जग्गी	Jaggi
मडरचोड़	Madarchod
बाते	Things
डसबन्टल	Dussbangal
लगटे	Looks like
अस्सलामुअलिकुम	Assalamualikum
चीड़	Pine tree and its wood
वाका	Waka
प्राचीन	old
फाफदा	Fafda
हम्बेय	Hambe
जौबगा	Jobga
ढेके	Dheke
घुसा	Entered
सुत	son
बछो	Save
कनफ्सन	Confson
गर्माई	heat
मथुरा	Mathura
टॉप	Top
दामाद	Son in Law
सिरीला	Sirily
पैर	foot
कॉन्ग्रेसियो	Congress
खाओ	Eat
ख्र्ब	Poor
तौबा	Vow to do no more
नागरिक	civic
बी	a vocative lady
हू	Hu
जाड	Thick
शहर	city
जाकास	Jacques
मार्डे	Marde
तायीर	Tayyer
थांक्स	Thanks
वात	air
भुलने	Forgetting
आइयेना	Not a
किजिये	Do it
डिज़ास्टर	Disaster
ध्यान	attention
सूपर	Super
मस्त	drunk
चैये	Want it
लेती	Takes
उल्टा	inverse
झुग्गी	hut
अंडर	Under
सरमिंदा	Sarminda
ज्योगी	Jewel
मोने	Mone
मन्थ	Manth
दिल्ही	Delhi
टाटा	Tata
टेकु	Teku
रंजना	Ranjana
व्द्या	By
पूनम	Poonam
ऐनवायी	Ayvai
सबित	All
मेस	mess
बडे	Big
इंकार	Deny
नन्नु	Nannu
ऑयर	Oyer
बचों	Survivors
जित्ता	Win
सरुख	Sarukh
ऊ	The sixth vowel of the Devanagari syllabary
कपूर	camphor
अक्षित	undecayed
मारवासी	Marwasi
धानसू	Dhansu
भरत	skylark
वानखेडे	Wankhede
हरेगी	Will lose
सोनले	Sonle
पताओ	Find out
काहनी	Kahni
किट	kit
यशोदा	Yashoda
टमसे	Tamse
मुट	Mut
घीन्न	Disgusting
नजर	sight
त्रह	Thirteen
सुदरेगा	Will improve
कसम	oath
नैश	Nash
मीनाक्षी	Meenakshi
अडने	Adne
सल्ग	Salg
सपनो	Dreaming
पट्टी	bandage
चुडाप	Chudap
दुसरी	Second
जग	Jug
वैसी	Like that
क्ञा	Why
जाटी	Caste
लौडा	Lauda
विचार	thought
चौक	quadrangle
पूछता	Asks
क्रांतिकारी	revolutionary
इस्लो	Islo
रजनीकांत	Rajinikanth
लोलज़	Lolz
धीमान	Slow
नियत	destined
भाना	to be liked
फूँक	puff
पार्टी	party
दिखाओं	Show
आयन्गे	Ayenge
आदिकर	Adikar
बोहट	Too much
फ्रॉम	From
सभकी	All
एक	one
नवाज	Nawaz
इस्टमल	Istmal
जमीन	earth
अनीश	Anish
प्कोडे	Pkode
वाश	Wash
कदमों	Steps
चुस्की	Draught or mouthful of water or other liquid
शक्ति	power
ए	The eighth vowel of the Devanagari syllabary
एस्मे	Esme
लगाये	Put it
मिलजाओ	Meet
गिरके	Fall
जानकीभी	I know
एज	Edge
देखूँगा	I will see.
आखें	Eyes
रास्ते	Way
मौकमौका	Chance
ऊह	deliberation
च्लेगा	Will work
पराडे	Parade
निहीई	No,
मान	respect
पूरा	small village
नेक	good
दुआ	blessing
मसद	Masad
घूरती	Gazing
रखियो	Keep it
जस्वीरमंकु	Jashirmanku
आईन	law
रीलैक्स	Relax
परी	fairy
गालिया	Galia
आधा	half
बाज़ार	market
प्धाते	
सबर	Sabar
बोखला	Bokhala
करुगी	I will do it.
सिंतक	Sink
प्रकट	evident
गिन्ती	Counting
लेडी	lady
तुम्हारे	You
करीब	nearly
सवसिंद	Savsind
सुभ	Good morning
तादप	Tadap
शोने	Show
अग्यि	Fire
भिंडी	lady’s finger vegetable
जयागी	Jayagi
निकेलेगी	Will come out
मीओव	Meiov
मिलुगा	Will meet
निकलेंगे	Will come out
गार	Gar
साबिथ	Sabith
मौसुम	Mausum
भाईजी	Brother,
देखेंगे	See
घोटेगा	Ghotega
साक्षी	witness
परिवर्तन	change
छुपाना	to hide
ईश	lord
फीलिंग	Feeling
फाडू	Fadu
बरबरी	Barbary
उतारकर	Remove it
बड़ा	A fried cake made of grounded pulse and spice
फिरल्हा	Then
जागो	Wake
दिक्कत	trouble
विलेज	Village
धन्या	virtuous lady
ख्ता	Khata
न्या	N.C.
आरा	Saw tool for cutting wood
निकला	Derives
साप	out
पढेगा	Will read
मुम्मियाँ	Mummies
समर्पित	dedicated
आन्दोलन	movement
राजपथ	highway
गेरेबाउन	Gerebaun
सुन्नी	an orthodox Muslim
ईक	One
स्मझाये	Understand
भेजता	Sends
पुस्तीन	Pustin
बत्तख	duck
बजरंग	Having a strong and sturdy body
राजकुमारीरानी	The Princess
ईसाई	Christian
अहिखर	Ahikhar
सोल	The under-surface of the shoes
ओल्सून	Olsun
अवोगी	Avogi
सोचने	Think
उठता	rising
मुबार्कन	Mubarakan
काइको	Kaiko
कोह	mountain
पार	the other side
वदो	Vado
करुण	sad
यादें	Memories
व्हाइट	white
मेहंत	Hard work
कुट्टिया	Dog
गुजरात	Gujarat
पापड़	Thin crisp cake made of any pulse
कोलावेरी	Kolaveri
शैली	style
कप्डा	Cloth
फैन	Fan
हमसाब	Hamsaab
फेंचा	Fench
जोकर	joker
गुडु	Gudu
लगराहे	Looks like
महारत	practice
होपायेंगे	Will be able to
अनुष्का	Anushka
बीज़ज़ती	Seeds
अकिरत	Akirat
पुछते	Asks
मिल्नी	Milny
एस्पे	Espe
मुस्लमानो	Muslims
जोब	Job
नन्दलाल	Nandlal
बहुचर्चित	much talked of
थोफा	Thofa
दिलाओ	Give it
यूउ	Yuu
धर्म	duty
आसानी	ease
क्रेगे	Craig
लाई	parched rice
इस्तेमाल	use
टिम्	Tim.
बैचक्पैन	Bachappan
मुहम्मद	highly praiseworthy
दिग्विजय	conquest of the world
बचने	Avoid
आग्य	Fire
भूली	Forgot
डेरा	tent
साली	wife’s sister
गैया	a cow
हैरन	Haran
लुगा	Luga
सुधरने	Improving
आप्किदिल्ली	Your Delhi
यार्र	Dude,
हाल्फ	Half
सभा	assembly
सुवार	Pig
टमटर	Tomatoes
डकह्कह्युंट	DuckKahyunt
लिल	Lil
ताबतक	Till then
गुरदेव	Gurdev
मालिक	master
हिरन	deer
शर्ब	Sorb
रहो	Stay
मार्र	Marr
जिंडिंगी	Life
ममकिन	Mumkin
पेडेज	Pedage
ओहो	oho
पारने	Parne
सीट	Seat
दो	the figure two
थोको	Thoko
करन	Karan
सपोर्ट	Support
हजार	thousand
मरेंगी	Will die
लखपति	millionaire
वाचानो	Read
दैयय्य	
बनावेन	Make it
अपन	we
कुंडु	Kundu
पाकिस्तानी	Of or belonging to Pakistan
देयर	There
आधे	Half
प्राप्त	received
अराम	Aram
टक	gaze
बकरी	goat
जामेन	Jamen
सौदा	frenzy
अजतक	Till date
सिक्के	Coins
बदी	vice
हुया	What happened?
पार्सो	Parso
पाहन्ने	To see
धानसु	Dhansu
टिल	Til
फुधे	Fudhe
हेलू	Helu
आइयो	Io
आत्म	pertaining to the soul
नारी	woman
मुअह	Muah
दन्याबाद	Danyabad
ईआसी	EIC
इडियट	Idiot
व्हाई	Why
क्यूं	Why
मात्र	merely
मेलिंगे	Mailinge
देरे	Dere
सब्सी	Subsidy
पाश	noose
डोलट	Dolat
दिवास	Divas
बेड	Beds
रख्ती	Rakhi
आल्गो	Algo
नरेन्द्र	Narendra
बाँटे	Share
हरा	green
वॉच	watch
अजयगी	Unbeatable
सल्लुउ	Sallu
पधना	Read
दुबारा	twice
वजूद	existence
आसाय	
झक्कस	Jhakka
बुलाया	Called
चलरे	Let's go
खर्च	expenditure
भूलो	Forget
अरविन्द	Arvind
खुइस	Khuis
रेहंडो	Rehando
रोपकिस्तान्रो	Ropakistanro
कार्थे	Carthe
सिस्टम	system
केरना	Kerna
उठाया	Raised
बैंग	frog
जमाल	beauty
असी	Asi
तेरा	thy
फेकना	Throwing
किरंजी	Kiranji
पिलाने	Drink
कंप्यूटर	Computer
इनी	ini
नकी	Not at all
इसे	thi
डेल्हिशो	Delhi
सबसे	most
ऑर	Or
कड़ी	hard
छोकरी	girl
रिमोट	remote
केजरीबाबा	Kejri Baba
रख	place
यू	u
तयार	Ready
पापा	papa
वैजन	Vaijan
चाड	Chad
हाक	Hawks
एजत	At the same time
चंद्नीगोदरा	Chandnigodra
बिमार	Sick
साका	era
बुरयी	Evil
बोउहूआआआआ	Bouhuaaaa
आपना	Yours
ताखो	Takho
बेचारा	without any resource
हमस्बको	To us
लड़कियो	Girls
किसान	ploughman
सिरसा	Sirsa
मुका	Muka
भुलयघाय	Forget
हिल्ला	Hilla
अभिन	Acting
बेलने	Belne
स्टेज	stage
दांग	Dong
दुडे	Dude
आएँगे	Arrive
अपनाई	Adopted
रेली	Reilly
पाकवसिंद	Pakvassind
सेरियसली	Seriously
एकेप्ट	Adapt
वालों	People
अविजित	unbowed
जिते	Won
इट्स	Its
बाढ़ो	Flood
बदय	Bad
आफ्तरी	Aftari
हेहेहे	Hehehe
दने	Dane
शुरुआत	beginning
पुरे	Enough
गुंडडा	Gunda
जीतेगा	Win
पायेगा	Will get
पहलू	side
अकेले	alone
हजारे	Hazare
छाप	stamp
कैम	cam
इलाही	divine
बोलडेट	Boldet
देखें	See
भैईईईईइ	Brother,
सबके	Everyone
चरस	charas
कुमा	Kuma
अना	Ana
प्रतिक्षिक	Symbolic
ब्टाआ	Tell me
कीम्टी	Kimty
ज़ी	zee
नहान	bathing
विदेसी	Videsi
यही	this very
वेका	Veka
दोफर	Dofer
कामचोरी	laziness
विश्वा	The World
लौडे	Laude
पितिई	Pityi
हिन्डो	Hindi
चुटिया	Tuft of hair on the top of the head men
एहसमान	Ehsaman
महनत	Great
एल्स	Elsa
बलाई	Balai
रहाणे	Stay
बोडे	Bode
गुमने	Missing
पाएगी	Will get
जिन्मे	In which
अपडेट	Updates
मेहंगी	Expensive
टोडे	Tode
जहरीले	Toxic
लुंगी	Long strip of cloth used like a dhoti
चाल	manner of walking
गर्ही	Garhi
आली	high
अब्बू	Abbu
दुर्दर्शन	Television
खी	
रजतिन्सा	Rajtinsa
सुरीया	Suriya
बनानी	Create
तुम्हारी	Your
डाका	dacoity
लौट	returning
जबतक	Until
पिचवाडे	Backyard
बांटना	divide
हूउ	Huu
फादु	Fadu
दयामेहर	Dayamehar
विजयवर्गीय	Vijayvargiya
सत्संग	association with good people
कर्वाएगा	Will get it done
सिखता	Learning
वागह	Wagah
मश्वरा	Maswara
इनवाइट	Invites
ब्टाइ	Tell me
नंदितो	Nandito
क्रुंगी	Krungi
सोफोल	Sofol
ब	The twenty-third consonant of the Devanagari syllabary
संतोष	satisfaction
लकर	Laker
टोक	zeal
नतेजा	The result
जिसा	Which
हैद	Haid
वॉमन	Womon
खोती	Lying
मुरेना	Murena
उम्मेद्वर	Candidate
ज़रुर्त	Need
डोजीना	Dojina
रूपया	rupee
औकत	Aukat
देखठे	Look at it
सपाथ	Sapath
दुशारा	The other
अब्बी	Abby
खून	blood
भारत	India
गिरना	to fall down
पेशावर	peshawar
दुश्रे	The other
समजो	Understand
बहुते	Too much
भगत	devotee
कन्फेशन	Confession
चाहिय	Want
खराप	Sore
मकद	Purpose
गौर	white-skinned
खेलुंगा	I will play
जाएँगे	Will
एसी	AC
मनोजपिंड	Manojpind
पॉपल	Popular
पापजीई	Papaji
पिताए	Father
आवारा	vagrant
हसीन	beautiful
वाजा	Waza
साबरा	Sabra
मार्ते	Marte
दर्र	Darr
ओडिशा	Odisha
चाहो	Wish
डेकोगा	Decoga
थू	The sound made in spitting
शायरी	poetic composition
स्टेट	State
आना	an old
हमारा	our
करिंगे	Will do it
ट्रेन	Train
मत	opinion
मंगना	Mangana
जाएगी	Will
फ्ली	Flea
इए	Ea
कमीना	low
कमलर्खान	Kamalkhan
इनानी	Inani
तनाव	tension
छ्ता	
मुद्दो	Issues
दुल्हन	bride
त्रि	three
नामी	famous
करोडो	Crores
सुर्धना	Surdhana
जारोर	Jaror
पिछ्ले	Previous
गरिबो	Poor
लुंचर	Launcher
आसे	Ace
असा	Such
धवन	Dhawan
इंड	Ind
नीवास	Niwas
मलेरिया	malaria
प्रेम	love
आसी	Asi
जलक	Water
दीप्ती	Deepti
लकड	Wood
ईव	Eve
वही	The same
जाम	jammed
उँचा	high
भारतीयो	Indians
राहमोकर्म	Rahmokarma
खायेंगे	Will eat
मन्हूस	Manhus
जितने	as many
नवा	bend
आप्केसट	Opset
सल्लुउउउउउउ	Sallouu
दीकत	Trouble
चाप	arch
नाज	pride
इलेक्ट	Elect
भाजपाईयों	THE BJP
मुजे	Me
पाका	Paka
हूहू	Huhu
सतलोकपुर	Satlokpur
रहम्त	Rahmat
दीवानिया	Diwania
हमार	Ours
हा	Yes
दिन्न्न	Dinnan
उद्बीलाओ	Excitement
खोड़	Khod
खाता	eating
ह्यूमेन	Humane
पटेल	village headman
जायेगा	Will
साठ	Yes
रमज़ादो	Ramadan
वसूल	acquisition
साइर	Cyr
सलामात	In peace
गेल	Gail
दुसरे	Other
काहिये	Tell me
लू	hot wind
चुराने	Steal
फना	Fana
सताओ	Torture
च्ये	Want
लगत	Data
कर्मो	Karma
तुझे	thou
जल्दीबाजी	Haste
सेरखान	Serkhan
रेअलीय	Real
मिस	pretext
तुमको	thee
पुंगी	Pungi
उद्बीलौ	Udbilou
फेब	Feb
दर्शको	Viewers
प्रोब्लम	Problem
मदर्चू	Mother's
चारयें	Four
सरदेसाइराजदीप	Sardesairajdeep
चीह	Chih
आएगा	Will
नामसे	By name
आजल	Ajal
गिद्गिदहट	Gidting
रहाई	Stay
कसक	twitch
मायावती	Mayawati
राखा	Keep
नादान	ignorant
बटी	Bati
गुड्डू	Guddu
उस्की	His
खमियाजा	Khamiyaja
बिन्दास	Bindas
होली	bonfire
मोबाइल	Mobile
आदा	Ada
ओवासी	Owaisi
खिलड़िओ	Players
बेहुदा	Stupid
सॉय	Soy
जंटे	Zante
मामा	maternal uncle
तलक	Talc
भेंचिक	Bhenchik
आन	prestige
तारेह	Tareh
चरोर्पति	Charorpati
कारिक	Carrick
नीति	policy
खोज	search
होट	Hot
धासू	Dhasu
सपना	dream
शान	dignity
टेनो	Teno
पाधी	Read
आगा	front
मरतिई	Death
हाडग	Hadag
यहीं	at this very place
ब्रेड	Bread
ओधा	Odha
बांग्लादेश	Bangladesh
सून	Soon-in-law
लिकेट	Lickett
ण्ड	N
थीक	Thik
बंदगी	salutation
ठक	tapping sound
शी	She
वाडी	Wadi
खर्चे	Expenses
बंध	tie
तुमरे	You
तारीफ	admiration
पोलिसियों	Policies
बंद	joint
माना	Believe
आप्दा	Apda
रामू	Ramu
विरोध	opposition
खतरनाक	dangerous
सिनेमा	Cinema
सहयोग	cooperation
चप्पन	A lid or cover of a large pot
हटप	Hatp
करोरो	Crores
सच्छी	True
म्यूट	Mute
आप्कासात	In your
ट्रायिंग	Trying
डैडी	daddy
लास्ट	last
थोक	wholesale
माँ	Mother
उपाये	Remedies
पैदाईश	Birth
नारीकी	Woman
हटालो	Remove
चिल्लाते	Shout
लोडा	Loda
देओ	Give it
एटन	Eton
चुटमे	Jokes
कुट्टो	Kutto
भुरे	Brown
पुत्र	son
इज	Is
अंडे	eggs
तोदो	Break it
भ्रष्टाचार्यो	Corrupt
करायेगा	Will do it
अपको	To you
शोले	Sholay
मेले	Fair
बकचोडी	
एस्सलामलाइकुम	Esslamlaikum
दावा	claim
जानकारी	knowledge
अमरदीप	Amardeep
दिलायेगा	Will give
दुसारा	The second
एगा	Will be
बजके	Ringing
उमरा	Gentility
आये	Came
भूपेंदर	Bhupender
पार्टीज	Parties
खेला	Played
सतनाम	Satnam
गुरा	Gura
हराया	Beat
शिवाय	Besides,
स्बका	Sbacka
केजरीवालोंत्व्फ	Kejriwal
मेहेक	Mehek
क्रवाडी	Krawadi
नाआ	Naa
थी	Was
तुषार	frost
अपनी	Your
शौकीस	Amateurs
वहा	There
फल	fruit
पोल	hollow
क़ुर्बन	Qurban
हुंदुस्तानी	Hindustani
लिओ	Leo
सहे	Sa
आयास	effort
ज्वाब	Answer
चोवक	Chovak
हाथ	hand
चाहत	love
साता	Sata
बारतिओ	Bartio
इंशा	Insha
चिप	Small piece cut or broken off from wood
टोइंगलिश	Toenglish
पिक	Indian cuckoo
मुंधडा	Munda
मिलाडो	Milado
नुक्षण	Nucation
फोकट	free
गिरीश्वंवरी	Girishwari
क्योंकी	Because
जरूरत	need
धो	launder
फुटबॉल	football
चादू	Chadu
बहू	bride
पांडी	Pandi
निची	Low
जेब	pocket
हाहाहाहा	Hahahaha
ग्रुप	group
क्रिये	Take action
कर्जत	Karjat
राज	kingdom
सरकारी	official
बब्बू	Babbu
ब्लियकमी	Blyakami
पागई	Pagai
बतडो	Tell me
आगाई	Arrival
मुस्कुरायेगी	Will smile
असम	unequal
शिर्फ	Shirf
हॉग्यी	Hoggy
लेलो	Take it
पहलाई	First
माई	mother
भाउत	Cow
गान	song
सक्सेना	Saxena
आद	Ad
चासे	Chase
लिय्ये	Take
पीचे	P.
पचौरी	Pachauri
लेगा	Will
भरोषा	Bharosa
सौभाग्य	Good luck
कलाधन	Black money
सत्ता	existence
गयेया	Gone
केजरीबाल	Kejriwal
जरिये	Via
हासी	jocose
घई	Ghai
चीजो	Things
चोरे	Thieves
जंगे	Jang
पीचले	Back
भूधे	Hungry
राफेल	Rafael
नलकूप	tube-well
छाये	Shadow
कजरी	A class of folk songs sung in rainy season
रेलबजट	Railway Budget
पायी	Indicating one or that which drinks or absorb
चुटा	Chuta
ओम्फगोमफगोम्फ	Omfgomfgomf
घुस	forcibly entering
किसी	certain
गुस्सा	anger
सिखाये	Teach
चाचा	paternal uncle
किरणबेदी	Kiran Bedi
आजायेंगे	Will come
खोलके	Open
कूट	fraudulent
कहीं	somewhere
सिखर	Sikhar
टोपी	cap
आपज	You
जाननार	Jannar
फर्स्ट	First
अमित	immeasurable
गल	throat
जारे	Go
लोकसभा	Lok Sabha
अलीशा	Alisha
बनायेगी	Will make
दुत्कर	Dutkar
भहुथ	Bhahuth
लगती	Seem
साहिलिंसा	Sahilinsa
त्यार	In the
चुटया	Chutya
करेगा	Will
निकलुंगा	I will get out
चेगा	Chega
क्रोलो	Crowlo
आओव	Come on.
तोड़दिया	Broke
गरीबों	Poor
शरर्ती	Sharti
फिंगरिया	Fingeria
डांडे	Dande
घमंड	pride
पिताई	Father
आर्ट	art
होस्टेल	Hostel
राखे	Keep it
माल्या	Mallya
सोचेगा	Will think
रीड	reed
लाये	Brought
संबित्स्वराज	Sambitswaraj
प्रूव	Proof
बढिया	fine
वाही	bearer
निकली	Turned out
धोखेबाज	cheat
युबा	Yuba
राइट	wright
फिर	again
होन	Yes,
वहान	There
मंडा	Manda
उद्दा	Udda
पडोसी	neighbour
श्वेता	Shweta
स्ट	ST
संसद	parliament
हान	Han
अवराट	Awful
सुनकर	Hearing
रू	Rs
पॉसिबल	Possible
फट्टे	Cracked
जैसन	Jason
भागते	Rush
अजल	waterless
अन्ना	Anna
पेरेंट्स	Parents
भैया	brother
कुबन	Kuban
माजरा	happening
आयला	Aayla
बड़कर	Big
इईईईईई	IEEE
तरक्की	promotion
बीच	middle
भारता	India
बोल	utterance
हथूदा	Stubborn
भैय्यों	Brothers,
पतंग	paper kite
बन्द	shut
सेम	bean
कृप्या	Please
दात	gift
सेफ्टी	Safety
स्मह	Smah
कृष्णा	Krishna
कार्दी	Cardi
थिंक	Think
आपकाकम	Your work
इस्कियास्की	Iskisky
खराब	bad
काबी	Kabi
दुब्ता	Dubta
देशराज	Deshraj
घुमाना	to revolve
विभाग	apportionment
सेडका	Sedka
सर्वेनाश	Destruction
मुंगेरिलाल	Mungerilal
फ्टके	FTK
सुब्को	Subco
अको	Ako
तेरी	thy
लोन	Loan
संत	saint
बैटसमैन	Batman
कोल्ग	Kolg
स्बेम	Sbem
बूथ	booth
मारकर	By hitting
थाब	Thab
सेगा	Sega
घाड़ी	Clock
फूट	dissension
दाते	Teeth
न्डत्व	Ndtva
याकिन	Yakin
न्ज	N j
पियो	Drink
पाता	Finds
बहलने	Flowing
जसी	Just like
फकू	Faku
भोलती	Bholati
लालची	greedy
कॉन्फ्सन	Confson
थोड़े	a few
बेयपाम	Beypam
उनसे	from them
समग	Samag
गुल्लू	Gullu
इटनय	Itnay
काफिर	kafir
भाईजान	Brother
गायब	missing
लगाके	Put it
थोखिन्डी	Thokhindi
बाधी	Barrier
केह	Keh
त्यो	They
दाना	corn
क्रोगेर	Kroger
मोह	infatuation
आसन	seat
कोहरे	Fog
खात्मा	End
लिये	For
धर्मा	Religion
हाश	Hash
भक्तो	Devotees
भगबान	God
पलट	upset
चिपके	Glued
रेहना	Rehna
भेजे	Sent
विदेशो	Foreign Abroad
बाज	eagle
निन्टेंडो	Nintendo
सुभाष	sweet speaking person
बैगन	brinjal
अस्स्लामलाइकुम	Assalamalaikum
चलेगी	Will work
क्रूउउउ	Crow
चाली	clever
बेरी	jujube tree
कमाल	perfection
क्राई	Cry
बेहिसाब	countle
उचाले	Raised
पैन	pan
मरोज	Maroj
क्सक्सक्स	xxx
झोल	broth
वापस	returned
लाम्बी	Lambi
ब्रह्मांड	cosmos
विपानिन्सन	Wipaninson
शपथ	oath
पीता	turmeric
पूछना	to ask
हैंडल	handle
लोगा	People
खाक	Floating around
नाही	No
उस्स्र	Ussr
मोहबत	Love
निंद	Slanderous
खॉ	O o
नौकारी	Job
विद्या	knowledge
कबका	When
इरर	Error
मांझी	Manjhi
जल्द	quickly
निईई	Niye
साबित	full
बघेल	Baghel
भारी	heavy
सनेज	Sunage
दुर्लभ	scarce
लोरे	Lore
मुहा	bribe
आजतक	Till date
वॉक	walk
बेया	Beya
लेटा	Lay down
अटारी	thatched upper room
यूही	Yuhi
लियो	Leo
सोना	gold
एवरयोन	Averyon
कराओगे	Will you do it?
ममला	Mama
कमा	conciliate
फोड़नेका	To break
सरी	Sorry
चीट	Cheat
हुर्र	Hurr
एटलीस्ट	Atlast
धडकना	beat
चुली	Chuli
कानून	law
गोबलिफाज	Goblifaj
चेप	viscous substance
हम	we
आया	nurse
हामरी	Ours
मवाहाहाहहाहा	Mawahha
आरहा	Coming
पिछवाड़ा	The back portion of a house or any area
बिक	Sold
सोमडे	Monday
जहान	the world
बजाये	Instead of
परेगा	Will be available
हिंद	India
संगम	confluence
तेज	warmth
गणतंत्र	republic
मेयो	mayo
कामयाब	successful
पन	Indicating quality or condition and corresponding to English suffix ‘hood’
केजरी	Kejri
हाहाह	Hahah
खोदा	Dug
स्टार्ट	Start
कान्ही	
लेगे	Take
जये	Go
नया	New
कजरीवाल	Kajariwal
विल	will
शरम	shame
मालभदा	Freight
कैटरीना	Katrina
भुवनेश्वर	Bhubaneswar
मेरी	My
ओहिर	Ohir
चोटिया	Peak
फटके	Cracks
इस्ली	Isli
स्वाच्भरतभियन	Swachhbharat Bhian
ठुम	Thum
देचिका	Dechika
पंखा	fan
कार्लेटा	Carletta
चलाता	Runs
स्कूटर	scooter
शीर	milk
ज़ेम्पर	Zemper
सेवक	servant
बुजती	Extinguish
पिडली	Pidli
नेता	leader
भीया	Bhiya
सांगा	Tell me
राखो	Keep it
प्रोफ	Prof.
अय्यो	Ayyo
पेशाब	urine
एंजेल	Angel
पर	given to
डीयर	Dear,
अज्हू	Azhu
नेहिन	Not
प्रसाद	propitiatory offering or gift
उये	Uye
रहती	Living
तेराय	Your
इसलिया	That's why
मझे	Me
बितवा	Divide
उशे	Ushe
वन	forest
नारे	Slogans
कारी	effective
कंड	smut
चेहरा	face
चिपक	adhesion
समय	time
चुनने	Choose
लगता	Feel
निकल	start
उदरवाडी	Udarwadi
बरना	Barna
आंशी	Anshi
तुझसी	Your
एंट्री	Entry
मुसलमान	Muslim
फितरा	Fitra
सहरो	Saaro
ल्डकियो	Girl
रेगा	Rega
मीलू	Milu
मंदिर	temple
कालते	Time
भेनो	Send it
भाय	Brother
काके	Uncle
पास	near
बाकर	Baker
पिया	lover
करवाने	Have
फायेदा	Benefits
बाइक	bike
निराश	disappointed
नकली	mock
नमाज	Prayers
भ्रोसे	Trust
थंग	Thang
चबद	Chabad
ह्यूम	Hume
ग्रिप	Flue
गडगे	Gadge
झोली	small bag
प्ता	PTA
करोड	Crore
तुकायी	Tukai
स्कतेय	It can
रीवाचिंगाफिनल	Rewachingafinal
रेआ	Rea
जबत्दस्त	Tremendous
सुनील	Sunil
चालता	Walk
बसप	BSP
गमबला	Gumbla
कहपे	Where
यद	However
कार्वटे	Carvate
हिलेगा	Will move
मनमे	In the mind
संभल	Steady
अचा	Good
हाये	Hi,
बैथने	Bethne
रोहित	red
मत्ल्ब	Meaning
सनडे	Sunday
गिरेन्द्र	Girendra
ऐला	Alla
तिलक	Mark of sandal paste on the forehead
विद्युत	lightning
सव	All
देकुंगी	Will see
सहब	Sahab
वाहा	Wow
र्खियो	Keep it
डॉन	don
दया	mercy
चे	Che
महोदया	madam
फिल्मो	Movies
मेहदी	Mehdi
ख्ते	Khte
होती	
कतम	Finished
लीटर	Liter
काफा	Kafa
छिज़	Chiz
बुलाने	Call
पुच	Pooch
आग्राही	Forwards
तारिका	starlet
मैमी	Mommy
जानकी	Janki
रुख	posture
आज़ाद	free
कीडे	Insects
दूसरो	Others
इशिता	Ishita
गाग	Gogh
एक्टर्स	Actors
खिलाड़ो	Players
कहिका	Kahika
थापड	Slapping
यूहू	Yuhu
पब	pub
बंदर	monkey
गिरवी	pledge
मम	Mama
लाओगे	Will you bring
हेक्कीह	Hekkih
दिखते	Look
सम्बन्ध	relationship
इज्जाजत	Respect
ब्लिंड	Blind
घरवालों	Family members
शशि	the moon
निकलता	Implies
फोजे	Foje
यादा	More
अतिक्रमण	infringement
फिरेदूले	Firedaule
टॉवर	Tower
कुट्टे	Dogs
बोलरे	Speak
देता	Give
इडमुबारक	Eid Mubarak
कहान	Where
जन्नत	heaven
सिखाया	Taught
रेहने	Stay
कुचनी	Crunchy
गावो	Village
निर्धारण	determination
समझाओ	Explain
शब्बाश	Shabbash
मुल्ले	Mulle
रेकस्ट	Request
बाचोगे	You will survive
वाऊ	Wow
झानको	Jhanko
व्हर	Whar
वाहवाह	Wow
सेवा	service
शेयर	share
फेकु	Throw
क्रदेगा	Will do
तप्क्ते	Heat
ससुराल	father-in-law’s house or family
टेलीचक्कर	Telecirculation
प्रजाति	race
कीचड़	mud
अनिवार्या	Mandatory
खुशी	pleasure
जररत	Need
दांके	Stings
बाईईई	Baiee
एच्चन	Achan
मीरा	Merry
स्टफ	Stuff
लगडा	Lag
डुंगा	Dunga
फ्रर	Frer
द्खना	Look at
कुच्च	Kutch
एस्तू	Estu
रख्ते	Keep it
मेहुल	Mehul
डोंग	Dong
तुमेह	You
दुसमनी	Dusmani
भाईई	Brother
फेइन	Fein
बोल्डस्लोव	Boldslov
अबकिबारबेदीसरकार	Abkibarbedi Sarkar
कसिस	Kasis
सवधान	Be careful
सुव्वार	Convenience
ठेकेदार	contractor
बिमर	Bimer
हुह	Huh
दय्यय्य	Dayayya
तरियादि	In the meantime
हुर्कुच्	Hurkuch
रौनक	Raunak
वचनो	Promises
दिन	Day period of 24 hour
लुलु	Lulu
फिरर	Then
रामल्लाह	Ramallah
मिंट	Mint
जान्ती	Know
बढ़ना	to increase
स्मजते	Understand
ओवर	Over
कप्दो	Clothes
बाँटा	share
हेंदू	Hendu
पौंगा	Punga
लोविंग	Loving
आँगी	Augi
नमस्कार	Hello
पुछने	Ask
जुमले	Jumla
दांगो	Dango
फेरते	Turn around
जूग	Jug
क्रेगा	Craiga
कांगरेस	Congress
सोहरान	Sohran
हप्पप्प	Happapp
ताकियो	Takio
जानो	Know
जेनरटन	Jennerton
फैल्री	Failure
नेहे	Nehe
मुवी	Movie
पेहेना	Wear it
एली	Eli
जुडेंगे	Will join
केजिये	Do it
हाहा	loud laughter
बच्चपान	Childhood
बचेगा	Will survive
रज्जी	Rajji
आँख	eye
सूफ	Suf
दिलाये	Give it
जोह	Joh
आखो	Look at it
मुछे	
डाल	branch
तोबा	Vow to do no more
निकलकर	Get out
महिनो	Months
लोव	Lowe
बधेगी	Will increase
वेनाश	Destruction
तुझ	Thee
मेरिया	Maria
उत्तम	best
रेगी	Reggae
थोकथोका	Wholesale
जल्दी	haste
बचाये	Save
किआ	Kia
चलांग	Chalang
रुपैया	Rs.
यार्काम	Yarkam
जगरूक	Jagrook
कैट	Kat
समा	Time
कारगिल	Kargil
तोड़ना	to break
जोतिश	Jotish
एस्लमा	Asselma
क्वेस्शन्स	Questions
मैया	mother
लनस्मुम्बाई	Lansmumbai
बतेगा	Will tell
मशीन	machine
इमन्दर	Imandar
ज़मीर	conscience
अमी	nectar
डोसा	dosa
हाट	a periodic market
टे	Te
अविनाशकिंकु	Avinashkinku
धुका	Fog
नोआह	Noah
चक्ते	Rashes
इतना	as much
हिंदू	Hindu
बीकी	Biki
कितना	How much
कामेना	Kamena
पाईदास	Paidas
दाद	ringworm
चाई	seed of tamarind
जुम्मा	Friday
टिएन	Tien
मेहंगा	Expensive
मंगनी	Matchmaking
रिटायर	Retire
अडम	Adam
झमेला	imbroglio
सुशीला	of good disposition
माकिन	Makin
अंधों	The blind
नवतंकी	New
गिर	fall
याह	The eleventh month of Vikrami calendar
रन	runs in cricket
मुच्ची	Much
लीयु	Liu
अरीरी	Ariri
पढ़ते	Read
भिकहिरियो	Beggars
तुमरा	Yours
चोरकर	Thief
राजनीत	Politics
केक	Cake
अखीर	Akhir
चंदा	subscription
तोजवान	Tojawan
सोनरीएंडो	Sonariendo
आके	Come on.
कमल	lotu
बेकार	unemployed
जूबा	Juba
कर्वोगा	Will do it
क्रू	Crew
हड	Hadd
आयेग	Will come
जबानी	Verbal
चिल्लना	Scream
चाइना	China
सल्लुमेया	Sallumeya
गे	gay
जस्त	zinc pewter
क्याआ	What?
पूरने	Old
मांगने	Seeking
हाजी	One who has been on pilgrimage to Mecca
देना	To give
बोलियो	Speak
राखीये	Keep it
सिख	Sikh
केएए	Kaa
समजा	Understand
थीई	Thei
नेवर	jingling anklet
प्रशांत	tranquil
गता	cardboard
एडमिन	Admin
दिखा	show
ऑस्विंज़	Ausvinz
ठाकुर	deity
तकलीफो	Trouble
करते	Do
बीयर	beer
गंदू	Gandu
शाना	Shana
बारिश	rain
चल्टी	Chalti
बॉलर	Bowler
चादर	sheet of cloth
हब	hub
पाड़ो	Read
माल	good
हिगाय	Higai
दीवाली	Diwali
केश	hair
गोड	Sweet
मेट्रो	subway
मायूस	disappointed
मत्लो	Matlo
शर्त	condition
कोंसा	Which one?
ज़िंदेगी	Life will come to life
करेब	Will do it
फर	fur
राहु	One of the twelve principal planets known to ancient astrologer
पहुँचा	forearm
छोट	Small
खुबशुरत	Beautiful
मुह	Mouth
छ्ड	Rod
अखबार	newspaper
धोकेबाज़	Fraudster
आस्पास	Nearby
नाडा	nada
सुधरे	Improved
मैच	match
सरर	Sarr
कीप	funnel
मस्लमन	Muslim
क्किआ	What is it?
बिड़ला	Birla
नामस्थे	Name
पाध्तेय	Method
कबक	When
जब्ब	Jabb
टीन	tin
अज़ान	Call to prayer given from a mosque
कुट्टन	Kuttan
पक्का	For sure
एड्रेस	Address
सज्जन	A good or noble man
अरुनजाइत्ले	Arunjayele
लमफाओ	Lamfao
बांडियाँ	Bonds
सफाई	defence
सा	The first and basic note of the musical gamut
पाधने	Read
पुच्नह	Ask
फिकर	Fikar
मतब	Matab
घंटी	tiny bell
आसरा	support
दादी	Grandmother
शुरुवात	Begin
रुपए	Rs.
सोहेल	Sohail
आइया	Come on.
बहिर	Deaf
किस्से	From what
बिग्र	Big
बेदर	Bedar
यहू	Yahoo
सैलमन	Salmon
चूटियाओ	Chutiyao
फेवराइट	Favorite
कट्टा	
अरहा	Arha
त	The sixteenth consonant of the Devanagari syllabary
फॉन	Fon
बर्र	wasp
क्रले	Crowley
चुथ	Chuth
आपक	Your
विनायक	An epithet of god Ganesh
लेये	Take it
तीक	
होशियारी	cleverne
अप्पका	Yours
विश्वनाथ	The master of the universe
एवम	And
डिज़िये	Give it
बढ़िय्यन	Good
धुंडते	Searching
खिचने	Pull
अली	Ali
बाधा	hindrance
धमकी	threat
परदे	Screen
नोजवानो	Nojwano
छुपाएँ	Hide
क्न्त्र	The Centre
पेसी	Pacey
अंदा	Egg
परसासन	Parsasan
चलना	big sieve
ब्नेट	Bnet
बजरंगीभाईजान	Bajrangi Bhaijaan
चरमीनार	Charminar
उल्टे	Reverse
परीक्षा	examination
इटनी	Itni
किसनो	Who is it?
पीपल	the holy peepal tree
चुड़ी	Bangles
मेटल	Metal
लागाय	
कहर	Havoc
लेके	Take
कटाई	cutting
डाटा	data
बचिया	Bachia
हममम	Hmmmm
तुर्की	Turkish
राहते	Lives
सचिन	Sachin
हसे	Laugh
पेलाओंग	Pelaong
दलवाया	Put it
जूट	jute
जो	who
जाइयो	Go
ख्ताम	Khatam
बदनाम	infamous
लगालो	Put it
जकर्ता	Jakarta
वजाह	Reason
समन	summon
सैक	Sac
लैडर	Ladder
गलत	wrong
पुरी	city
रेहकर	Rehkar
बालक	boy
मांगे	Mange
खुला	open
भेजो	Send
फिल्मी	Film
फ्लावर	Flower
छ्क्र	
कर्ताहा	The doer
इमादरी	Imadari
ब्तायेगा	Will tell
साइमन	Simon
बडलेगा	Will increase
सुनू	Listen
हरेंगे	Will lose
उत्रा	Get down
बन	forest
रोगे	Disease
यशोमति	Yashomati
आज	today
दुखु	Sad
नाय	No,
बंट	Divide
हाओ	Sal tree a timber tree
आने	Come
गोटी	Small stone or wooden block used for indoor game
सक्तेन	Sakten
सन्ड	Sund
पेहेले	First
सिरसी	Sirsi
मिलेगी	Will
कैंसल	Cancel
वोटर	voter
इस	this
घण्टे	Hr.
किसिकी	Someone's
वकाई	Wakai
टिंगू	Tingu
पहनी	Wore
सुनेंगे	Hear
मिलये	Meet
दर्पण	conceiting
ह्गा	Hga
आयेगा	Will come
चलायी	Run
कोलकाता	Kolkata
व्व्व्व्व्व्व	
सायसरा	Sysra
दुंडा	Dunda
सादी	Plain
होश	consciousne
मतलब	purpose
चिन्ने	Chinne
मानके	Standards
आवोगे	Will come
आवा	potter’s kiln
बंटने	Dividing
बढ़ते	Mounting
तोदेगी	Will break
एगेय	Agey
सैन	sign
कार्डोना	Cardona
डिज़र्व्स	Disrovs
उह	Uh
परतिया	Partia
हुसने	Husne
राजाई	Rajai
सर्फ	Surf
लगायी	Installed
एसाई	Esai
शूज़	Shoes
कामियाब	Kamyab
आयिये	Come on
बेखबर	unwitting
हिईई	Hiei
क्षमता	competence
कार्ट	Cart
बैंक	Bank
क्बी	Kbi
ने	Ne
पॉकेट	pocket
कुन्दराबावा	Kundrabawa
अछी	Good
लानी	Lani
बाधकर	Bindkar
ज़रोरी	Essential
सानिया	Sania
केहा	Where
आज़ादी	freedom
बिश्व	The world
ब्	b
सजाने	Decorate
किस्सी	Story
भदवा	Bhadwa
गांधी	perfume seller
संभली	Sambhal
गद्धों	Donkeys
बम	Side bamboos between which a horse is harnessed in a tonga
सेंटी	Senti
चुपाई	Hiding
जायी	Go
फन	hood of a snake
सदर	head
ध्रिधता	Perseverance
गंडू	Gandu
कासी	Kasi
घंटा	bell
पंगा	crippled
लग	touch
आरेय	Hey
निस्बत	connection
भाईयून	Brother
लडकिन	Girl
हाजीपुर	Hajipur
बोलती	speech
मन	mind
निगल	swallow
बंटी	Branching
रेचेकिंग	Rechecking
रुका	Stop
लाफिन	Laffin
हाल	condition
कुचल	step
चिंतन	contemplation
चैईया	Chaiyya
धारा	flow
अच	Good
एस	ace
कार्चक्ति	The work
लिजिये	Take it
माजबूट	Strong boot
लगाने	Putting
तारे	Stars
घुमने	Walking around
इन्सा	Insa
भीम	terrible
यो	Yo
गुड्डा	doll
ज़मीन	land
हिजडे	Hijde
हिल्बा	Hilba
पज़ामा	Pajamas
आकी	Aki
किजिया	Kijia
पिछे	Back
यत्रा	Journey
हरे	O Lord
फिरवैयेगा	Will do it again
पदेगी	Will read
बेटियों	Daughters
शरमनाक	Shameful
दीवानो	Crazy
ओलाद	Olad
ल्लाह	Allah
कामती	Kamati
मर्द	male
बेजने	Bejne
उत्साह	enthusiasm
पड़के	Read
पढ़ता	Reads
बेरोजगार	unemployed
नन्दलाला	Nandlal
टूट	breakage
यारो	Yaro
इन्सन्नेहा	Insanneha
जेकर	Jeker
मिरांडा	Miranda
जाग	awakening
दलेहा	Daleha
उद्द	Ud
कामिनो	Kamino
छोड़ता	Leaves
इलोवे	Ilowe
नेचे	
जैन्द	Jand
होक्र	Yes,
मिल्ट	Milt
हुई	Happened
मुल्लास	Mullas
बेज़टी	Bezti
किस्कू	Kisku
चुचु	Chuchu
प्यारे	dear
हिन्दू	Hindu
ज्न्गलतमैट्व	
सालाम्न	Salam
घमे	Throat
सिमरन	Simran
अक्की	Akki
पातर	Pale
सोहना	To look pretty or pleasing
हरये	Lose
उतार	descent
कातिल	murderer
सितारों	Stars
आवारे	Aware
चक्की	pulveriser
शर्माना	Shyness
एडमिशन	Admission
तू	thou
पेले	Pele
किस्म	pattern
बफ	Buff
बीरयान	Biryan
ख्दा	Khda
तोली	Toli
खासे	Very good
मामो	Mamo
बल्क	Bulk
न्ये	New
मोजोरोजो	Mojorojo
काह	Kah
स्टोक	Stock
इरफान	Irfan
मासिनसिनेमास	Masincinema
वीक	week
सैलो	Salo
करेगे	Will do it
जाप	Adoration by repeating phrases or mantras from scriptures
कार्यकर्ता	worker
मुफतखोर	Free taker
कहती	Says
सफदरजंग	Safdarjung
मध्यम	medium
मैनू	Menu
बाहर	outside
अब्बे	Abbe
भुलना	Forgetting
देखिया	See
हमाशा	Hamasha
ब्टाओ	Tell me
वाणी	voice
इशकशादे	Ishaqshade
संभला	
कान	ear
स्केच	Sketch
ब्रो	Bro
समज्ते	Understand
न्ह	No,
मोहम्मद	Mohammad
प्रधान	head
फैट	Fat
मेसे	Mese
चुनाओ	Choose
बरीश	Barish
गयीं	Gone
सम्झया	Understand
लिखुम	Write
उषा	dawn
प्रचार	propaganda
आचो	Achon
मुसमानो	Muslims
हर	every
स्वीथअर्ट	Sweetheart
इंडिया	India
किसिने	Someone
काफी	quite
सुजाओ	Sujao
उसने	He
आलय	abode
चर्चे	Discussion
याहा	This is
तुटेगी	Will break
अभियान	campaign
लोयल	Loyal
बिश्वास	Biswas
झकास	Shock
फ्रान	Fran
चोर्टेरा	Thief
देखुगा	I will see
मोदीजी	Modiji
पिलाउन	Pilaun
कासा	Casa
काम्याब	Successful
आरक्षित	reserved
कितिया	How much
वाजसे	Waze
जीसस	Jesus
रुई	cotton
छाट	Sort
उद्द्योग्पतियो	Entrepreneurs
होते	
रंजीबमज़ुमदर	Ranjibam Majumdar
इत्विंगड्स	Itwings
गेडियन	Gedian
रंगत	hue
अबके	Now
ज़ारा	Zara
सल्ल्ल्लुउउ	Salluu
बुधा	Mercury
पोहोच	Reach out
निकी	Nikki
विवेकानंद	Vivekananda
अंगूर	grape
स्वच्छता	cleanness
धक्का	shove
चाहने	Wanting
अल्वा	Alva
बवलिचोरी	Theft
कूम	Koum
स्म्भल	
लोकोको	Lokoko
बेशरम	indecent
कामिना	Kamina
पांडे	Pandey
लव	tiny particle
आन्ना	Anna
ईवा	Eva
इंताज़ार	Waiting
फिर्स	Firs
डिपेंड	Dependent
खरा	genuine
जाएता	Go to
रंडवे	Randway
बर्दश्त	Tolerating
कोंपेद्तवु	Kompedtavu
आर	enmity
परिधानों	Garments
दिल्ली	Delhi
नाहू	Nahu
रूप	figure
परिवार	Family
हलीम	humane
पट	cloth
अंसू	Tears
भागे	Ran
नाले	Drains
थ	The seventeenth consonant of the Devanagari syllabary
पल्टेगा	Paltega
बनाते	Create
इंशाल	Inshaal
शीत	cold
क्रेज़	Craze
छोड़ा	abandoned
अजाओ	Come on.
आतम	Within
नी	Ni
कर्ज़	debt
ऐंगे	Angle
निभाया	Fulfilled
बागो	Bago
जनवाद	Democracy
आयेतो	It comes
बनायातो	Made
समजहा	Understand
उत्ती	Utti
बाहिया	Bahia
आभी	Right now
शहीद	martyr
मज़य	Have fun
त्वरित	accelerated
लोवी	Lowy
शादी	joy
मंजा	Manja
भिकारियो	Beggars
बजराहगी	Bajrahgi
एच्चे	True
र्क्खी	Rakkhi
बोली	dialect
क्र्क	Crk
गधेले	Donkeys
बचाए	Afloat
बटती	Bat
धूदू	Smoke
विधायक	legislator
पिछवाडे	Backyard
टम्सी	Tamsy
पीटे	Beaten
चक्र	wheel
न्ही	No
करोदपतियो	Millionaires
आगाय	
अर्थात	i.e
कावली	Kavali
चम्दी	Skin
औलद	Child
काल्पनिक	imaginary
ध्ब्बा	Dhbba
लाल	ruby
जनलोकपाल	Jan Lokpal
बानी	voice
ग्राव	Grave
प्स	P.S.
जस्टो	Just
डम्प	Dump
एप्क्स	Apps
वॉनडीईरफुलफुलफुल	Colorful
साबका	Saabka
पोश	covering
ब्दीय	
खुरान	Khuran
पैरों	Feet
खोलिया	Opened
मार्टा	Marta
श्याम	dark
मालनदाय	Freight
वाडा	Wada
सैफ	Saif
टोड्रोज	Todroz
डेगिन	Degin
योयो	Yoyo
फोरवेर्जेती	Forwardetti
भायो	Brother,
यूरोप	Europe
बहा	Shedding
मेगटे	Megte
सीख	advice
शुभ	the good
जीई	Ge
राये	Raye
ज्नकी	Jonki
कुयु	Kuyu
आरीई	Aari
करदुगी	Will do it
आश्रम	hermitage
लाडला	darling
आईएयतोह	Iaytoh
हालात	circumstance
क्रेन	crane
होए	the moon
जंब	Jamb
राह	way
चैपड	Chapad
इट	It is
वेड	Wade
हिबा	Hiba
सिधा	Straight
देयो	Give it
डोजी	Doji
बताओहा	Tell me.
ढेयन	Dheyan
पेने	Payne
कार्डियो	Cardio
मौकाआ	Chance
याद	remembrance
उम्माह	Ummah
क्रवाते	Perform
सालू	A kind of red cloth
लत्का	Latka
एतनी	So much
अड	Ad-y
एपक	App
आराय	And
धा	Feature
सिकहने	Sikane
नीच	low
केजरू	Kejru
नागर	civil
ज़रुर	certainly
बचाओ	Save
ताकलिफ्दा	Taklifda
कुटियो	Cottage
नंद	joy
देखता	seeing
सुबी	Subi
सामजे	Understand
भाने	Bhane
होरा	Hora
बांगाये	Bangaye
बनता	Formed
हराई	Harai
बताता	States
बॉयफ्रेंड	Boyfriend
पिछले	Last
सदी	century
कुचे	Kuche
अखयी	Akhayi
ऐसी	Such
नोट	currency note
बोलेंगेई	Will speak
पेयेंगे	Will get
जानू	Janu
दीद्दार	Diddar
स्बको	Sbko
भरोषे	Trust
लौंडा	boy
बंगे	Bange
जामिया	Jamia
जियादा	Ziada
बोलेगा	Will speak
हुकम	Order
थिंग्स	Things
राधा	Radha
बिचे	Biche
क्रांति	revolution
अखिलेश	lord of all
जाता	Are
चपचाप	Quietly
पायर	Pier
पेसे	Money
अपका	Yours
दोउ	Do it
रुक	stop
दोहरी	Dual
होनहार	destiny
होपायेगा	Will be able to do
रोहन	Rohan
टैंग	Tang
दुकान	shop
दरगा	Dargah
काकिब	Kakib
समजदार	Sensible
जालने	Traps
मुफतखोरो	Free
नुस्क	Nusk
फेर	turn
आनसु	Tears
मासी	maternal aunt
तक	until
डीनो	Dino
बड़ी	Dried tiny balls of grounded pulse
धुंधे	Fog
बाई	lady
पित्ता	gall-bladder
हिंदुस्ता	Hindustan
गाग्स	Gags
देखेगी	Will see
पदली	Fell down
आगाये	Come forward
तुम्पे	You
काबेर	Kaber
बदमाश	wicked
थाईद	Thailand
होगा	Will
दाश	Dash
चुकी	Mistake
रा	Ra
कायी	
वेरी	Very
लोटा	A round type of jug
पुनीत	pure
जासूस	spy
बेलन	roller
चुटियों	Jokes
आन्ने	Anne
कितनी	How
हेगर	Heger
जीत	victory
गजानंद	Gajanand
बीवी	wife
सहमत	agreed
बटकर्ने	Butkarne
सविनय	courteously
लायी	Brought in
फुस्की	Fuski
नल	water-tap
नप	Nap
निकलो	Get
लगे	toward
चलेगा	Will
उस्मे	In that
आर्रेय	Array
नज़ारे	Views
निज	own
हुथना	Huthna
बत्या	Batya
क्रियू	Cryu
चाहता	loved
दबंग	bold
छोड़ने	Leave
सिवा	Except
द्खिये	Look at
ज़ूर	Zur
ग़ज़ाब	Amazing
आईईईईएई	IEEE
बोलाये	Speak up
केबिन	Cabin
पड़ती	fallow land
बछोन	Bachon
अधुरा	Incomplete
सोनाटा	sonata
समोसे	Samosa
जीसे	From
सुधारने	Repair
क्रति	Culture
मार्ले	Marley
खरीदने	Buy
बेघेरत	Restless
बू	smell
को	for
टाइप	sort
हाहाहाहाहा	Hahahahaha
चिचा	Chicha
चुपन	Silence
हनुमान	Hanuman
कथूला	Kathu
ज़रुरर्त	Need
कायू	Kayu
गग्ग	Gagg
आप्योगेन्द्र	Apyogendra
उदा	Ex
चाइनीस	Chinese
सतगुर	Satgur
पैडल	pedal
आल्लाह	Allah
सनम	lover
आजकिपर्टी	Today's
इंत्ज़ार	Waiting
पितायी	Father
निकालते	Remove
लिहो	Write
हिईईई	Hieee
एकबर	Once
ईस्वरिया	God's
बढेगा	Will increase
सखते	Sakhton
एडवांस	Advance
रमज़ान	The month of long fasting by Muslim
जीते	Live
मूँग	a kind of pulse
काग	crow
अमीन	a petty revenue officer
लूक	falling or shooting star
हाफिज	Hafiz
कुटी	hut
जाड़ा	cold
महाईन	Mahain
पाय	Feet
केर्ते	Kerte
नार्कमी	Narkami
साय	Sai
कब	when
होनी	destiny
रैंडी	Randy
गिरी	kernel of a nut
खुजलीवाला	mangy
भोषा	Bhosha
अचानक	suddenly
बतानी	Tell me
पर्ता	Parta
इम्प	Imp
भरस्तचार	Corruption
सतगुरु	A true and ideal teacher or preceptor
वेल	Well
डाई	die
जरूर	fine
इज़त	Respect
भाभी	sister-in-law
सुक	Suk
केलिये	For
हरकत	motion
अभी	just
बव	Wow
जिन	oblique pl. of
आग्या	Fire
बिजली	lightning
मानवा	Human
कन्फेशन्स	Confessions
हलवा	A sweet dish made of flour
फ़ैमिली	Family
बेरोजगारी	unemployment
इटने	It's
गुंजिया	Gunjia
चालके	Drivers
बीकफ	Bekoff
आप्तक	Aptak
सिचुएशन	Situation
आँखो	Eyes
बहना	of water to flow
ईश्वर	lord
चलनेय	Walk
जुते	Shoes
बांजूऊ	Banju
ग्रेट	Great
सप्रब	Saprab
लाडू	Laddu
लीला	sportive display
अवसरामा	On occasion
विधानसभा	Assembly
कसरत	physical exercise
निखिल	entire
हुग	Hugh
बुद्दू	Buddu
दातार	giver
डैन	Dan
लीटा	Lita
सुलमान	Sulman
तोड़ी	mustard plant or seed
रहमत	divine mercy
तोवा	Towa
बुडडे	Sinking
रात	night
धरती	earth
हता	Hata
विराट	V
कहाइटे	Where
मोहपात्रा	Mohapatra
जीतन	Win
तोही	That too
उनिवर्स्टी	University
निच	Low
कांग्रेसी	Congressman
बाजार	market
हुकुम	command
परमार्थ	The highest or most sublime good
ऑस	Os
किसिको	To someone
दिये	Given
लगन	auspicious moment
किस्सा	anecdote
मेनी	Many
काँचे	Glass
दाले	Pulses
क्रीना	Crena
किनारा	edge
ज्येगी	
जन्म	birth
गलती	wrong
रायता	curd mixed with vegetable
काया	body
रोड	road
टीचर	teacher
जला	burnt
काता	spun thread
स्तिथि	Status
मुशयरा	Mushaira
अत	therefore
शूतेगी	Shooti
नास्पीटे	Naspite
गुरुधेव	Gurudhev
पाठके	Readers
खिलंगा	Khilanga
संगठनो	Organizations
कोयी	Anyone
रोयेंगे	Will cry
आए	Came
आपकिशपथ	Your oath
कोटा	quota
अभे	Now
फला	Fruit
शोरो	Shoro
सचदेव	Sachdev
रेहती	Stay
पोना	To make the dough into a loaf of bread
चुटकरा	Jokes
दिलवाना	To cause to be given
निकल्टी	Nickel
कोज्जुराग	Kojjurag
पका	ripe fruit
सर्कस	circu
क्यू	queue
देखलो	Look at
आईआम	Iam
पिलाऊ	Drink
ज़लील	abject
माद्रे	Madre
पुलिस	Police
चुटियापा	Chutiyapa
प्रॉब्लम	Problem
हिंदुस्थान	Hindustan
आपन	Your
हरमखोर	Haraamkhor
अवार्ड	award
बनाया	Created
लेज	Lease
फ्रेंडशिप	Friendship
नाराज	Angry
बेल	Wood-apple tree and its fruit
जेल	jail
मिले	Are
हॉकी	hockey game
बहुत	A lot
सैट	Sat
देखने	View
मुर्ख	Stupid
दौलत	wealth
जॉर्ज	George
राल्लेय	Ralleya
हैम	Ham
रेंगे	Range
केन	Ken
अप्पसे	Apps
तोफियाँ	Toffees
केरता	Kerta
बोलता	talking
पोस्ट	Post
देंगू	Dengue
जूते	footwear
नेट	net
ओवैसी	Owaisi
जश्न	festivity
बस्ता	satchel
लम्बे	Taller
अनवरन	Untitled
इंडियन	Indian
धुन	tune
बुधी	Wise
होने	Be
ईस्बर	Isber
जयललिता	Jayalalithaa
उसर्ट	Usart
हराओ	Beat
यात्रा	journey
जेंड	Zend
पापी	sinner
हैल	Hal
इटली	Italy
उआंग	Uang
ड्रा	Draw
प्राथमिक	primary
जनब	Sir,
हिहुन	Hihun
मोदीसरकर	Modi government
घजाने	Ghajane
प्रगति	headway
जैसा	similar to
अड्ड	Add-on
प्	P
सेहन	Sehan
भागा	Ran
डर	fear
हुहा	Huha
सस्ती	cheap
उमिद	Hope
बेसबरी	Besbury
देखके	Look at
स्लो	sloe
दिमक	Termites
रीलाइज	Release
मुबरखो	Congratulations
होवा	Be
गागा	Gaga
पाउआ	Paoa
लडकी	girl
कछुवा	turtle
बोलडो	Boldo
सबकी	Everyone
चस्मा	Glasses
लॉन्डे	Launde
चुरी	a small well
मानेन	Manen
फरिग	Farig
बुरी	bad
कक्किक	Kakkik
कामयी	Kamayi
आचे	Ach
मर्तबा	degree
हरमजादो	Harmajado
ढेर	heap
अपना	one’s own
उथले	Shallow
दोसुमान	Dosuman
उनको	them
जराहे	Just a little
बोर्ड	board an administrative body
काले	Black
नपुंसक	neuter
पकदो	Catch it
दीवानी	mad
मुन्नी	Munni
माइंड	Mind
विदेश	foreign country or land
ज़ुबान	Tongue
बुज़र	Buzer
सुसरा	Susra
बहती	Flows
सोंच	Think
तगा	Taga
बौथ	Bath
कौंसा	Which one?
बॉब	Bob
केहे	Why
तख्त	Cots
लेक्चर	lecture
बटन	button
चंद्रा	an open verandah
दिखाये	Show
भयानक	terrible
मुस्तफा	Mustafa
खीर	Dish of rice cooked in milk with sugar
बैच्चेय्य्य्यय्य	Bachaiyya
टम्पथ	Tampath
ईसा	Isa
शहरो	Cities
सनिमा	Sanima
मनाते	Celebrate
पिंजडे	Cage
बद्सुरत	Badsurat
वह	that
हमटो	Hamto
अप्रतिम	matchless
बहेंचोड़	Bahenchod
मलिकम	Malikam
जुलवानिया	Julvania
केरो	Cairo
मुस्लमान	Muslims
ईमान	faith
हलचल	agitation
सीचा	See's
अगले	Next
ख	The second consonant of the Devanagari syllabary
सुनयी	Listen
रियलिटी	Reality
सिया	Sia
भीकारी	Beggar
मैन	Man
कैसी	how
कला	pod of a bean
नाजरे	Nazre
वाप्स	Backs
इंटीमटे	Intimte
जनाब	your honour
लु	Lu
फिरेन	Firen
हासे	Laugh
इर	Ir
तनिक	a bit
बैक	back
शिप	ship
पहुचा	Arrived
रखवा	Keep it
देखो	Look at
फौज	army
सापने	Snakes
इड	id
यदेवन	Yadevan
ओकी	Oki
चिपकु	Chipku
हनु	jawbone
ट्रूटी	Error
चुटियापांटी	Chutiyapanti
किये	Done
लगाम	bridle
रीता	empty
क्रोरपति	Croarpati
होरी	Hori
याहना	This is
बुलंद	high
सेई	Sei
गो	cow
थाय	Thai
सेनर्स	Seners
थुरस्डे	Thursday
ऑफिस	office
थूधू	Thudhu
लेले	Lele
सोनियाजी	Soniaji
एग	Egg
आगये	The fire
चुरा	steal
जायज	Justified
पैसे	money
फराज़	Faraz
पुष्टि	nourishment
किशि	Kishi
कामीन	Kamin
सिलसिला	serie
थंध	Cold
इल्लाज	Illaj
दिया	given
क्बताब	Why
कुट्टू	Kuttu
सिक्टी	Sikti
मेंहनी	Mehni
मारा	beaten
का	of
बेबसी	helplessne
इफ्तर	Iftar
जारुरी	Necessary
हिल	rock
स्वाच्छ	Clean
खुले	Open
गुना	time
मिकलुन	Miklun
लन्गे	Lange
थंधियों	Cold
फेके	Throw it away
जरुरत	indispensability
मारी	epidemic
लड्डू	a ball-like Indian sweet-meat
मनका	bead
जानी	beloved
वाल	Wall
घूमो	Walk around
करडोंगा	I will do it.
रुपये	Bucks
टेक्स	Tex
एन	en
झूम	swaying
मार्क	mark
बाकने	Bakne
लाट	lord
अर्बी	Arby
नाग	cobra
जाओ	Go
तेरे	Thy
सच्चे	True
शदी	Century
चुनाव	election
रेहिये	Stay
गांधीजी	Gandhiji
छ्ल	
खवैश	Khavaish
देंगे	Will
फ्ब्लिव	Fbliv
बुल	Bull
टमको	Tamko
मारियो	Mario
मुनह	Munh
मर्ण	Death
गाइडलाइन्स	Guidelines
औओओ	Oooooo.
भेक	toad
कुरते	Kurte
निवासियो	Residents
करलेंगे	Will do it
हूराय	Hurai
खासने	Especially
संजता	Santa
पडेगा	Will fall
जाओगा	Will go
नेक्ट	Next
शानोने	Shanone
तश्रीफ	Tashrif
ताद	Palm
डायलॉग	Dialog
काने	Ears
एशिया	Asia
सिररर	Sir,
शायद	May be
परसरित	Transmitted
कटिलाना	Katilana
गर्मी	heat
चिंकारा	gazelle
अमला	staff
खानसी	Cough
वुब्ब	Wubb
बैठता	Sits
भोंके	Bark
जवाब	to a question answer
तुम्हें	to you
शाधे	
रन्दीपना	Randeepana
मरजी	Will
राहना	Stay
बांके	Banke
होताहा	It happens
तरीके	Ways
खोली	covering
व्ररी	Vri
ब्धिया	Bdhiya
अंस	shoulder
आवन्तन	Allocation
सबाह	Sabah
पाते	Find
बदबू	foul smell
मौत	death
इराडे	Intention
र	The twenty-seventh consonant of the Devanagari syllabary
नाचो	Dancing
कुंजिया	Keys
खुश्या	Happiness
पोस्चिम	Poschim
चलन	detached
हमेशा	always
अरविंदकेजरीवाल	Arvind Kejriwal
इत्ता	It's
हुऊ	Hu
केन्द्रिया	Central
उस्दीन	Usdin
भूगत	Suffering
ईमा	Ima
देकुंगा	Will see
गाल	cheek
असली	genuine
बारेय	About
थेघन्ता	Theghanta
बस्नी	Basni
उन्ही	To
जनना	to give birth to
यनाहा	Yanaha
टेकेकककक	TechCake
मरी	epidemic
एहसान	obligation
देखोगे	Will see
इंट्रव्यू	Interview
तुझसे	with thee
अजो	Ajo
इति	end
लोग	people
रेगे	reggae
सुन्दर	beautiful
आर्ररी	Arri
दिखती	Looks like
खाये	Eat
सबको	Everyone
लागवाई	Applied
न्सुई	Nsui
नौटंकी	Folk-drama with music and dance
दिखेगा	Look
स्वामी	master
बदो	Grow up
जवानी	youth
अमजद	Amjad
बध्ती	Binding
वालो	People
भिआ	Bhia
टीम	team
मोरदबाद	Moradbad
साठे	Stock
गनिटगुनिट	Ganitgunit
सुअर	pig
वाह्यूह	Wow
जुज	Juj
हामसे	From us
वाले	Those
चुपचाप	silently
प्रिवार	Prewar
नामोनिशान	trace
वंदना	bowing
स्माज	Smaj
वाइड	wide
हवलदार	a petty military officer
लिक्टा	Licta
आई	coming
हार्पिक	Harpic
वाह	bravo
बीख	Beak
डुंगिया	Dungia
अकरम	Akram
आखिरी	final
जगबीर	Jagbir
टमह	You
पु	Pu
ब्लोग	Blog
खुस	Happy
अंधेरे	Dark
जीजे	G.J.
कॉन्ग्रेचुलेशन	Congregation
कार्ति	Karti
होगाया	Will it happen?
सीमा	border
लड़किया	Girls
भुलकर	Forget
दित्ती	Ditti
कर्ले	Curley
क्रेंज	Krange
अजायेगी	Will come
कम	short
सर्करेन	Circen
शिर्क	Shirk
वफादार	loyal
होगाई	It will happen.
फादू	Fadu
प्लस	Plus
बाल	ear of corn
रत्न	precious stone
फ्लांग	Flanag
घोर	awful
अमेरिकी	American
नुक़सान	deficiency
ज़कात	alms
पानूती	Panuti
बच्चन	Bachchan
छोटी	short
कित्ता	How much
अबीसाप	Abisap
इस्के	Iske
पानी	water
भूटनी	Bhutan
समज	Understand
सैल	Sail
लूथ	Luth
फ्रिडे	Fride
जाँच	test
काली	goddess Kali
प्रांत	province
स्ल	Sl
होराहा	Horaha
जिन्को	Jinko
बास	scent
गाये	Sing
पिताजी	father
सूख	Dried
हाराय	Losing
लबनोल	Labnol
महेश	epithets of god Shiva
केवल	only
वजे	
रगेस्त्र	Register
सफ़ेद	white
योगा	Yoga
सिधे	Straight
लून	common salt
तोड़ता	Breaks
भलायी	Good
हिआ	Hia
मेडन	maiden
उतेर	Uther
लगेराहो	Lage raho
तबियत	Health
दिदार	Deedar
मौसम	season
रोको	Stop
पीचली	Back
बूदेह	Budeh
जस्ट	Just
लावडा	Lava
आपको	to you
हॉल	Hall
भोस्दी	Bhosdi
पैदायशी	Born
सोचु	Think
चपल	fickle
तरहा	Like
हुमेय	Humaya
सुपर	super
दुमलागकेहेशा	Dumlagkehesha
नोबोडी	Nobody
गयाब	Missing
कत्तिफ	Katif
बाँट	share
चिपका	attach
बदलती	Changing
सुमति	right way of thinking
पकोदे	Pakode
सबकुच	Everything
मको	Mako
जिंके	Win
चाहेगा	Would
ब्रेकअप	Breakup
नेहरू	Nehru
इसात	In this
खुशिया	Happiness
भालाई	Spear
गए	Gone
खोलते	Open
पूरे	Whole
लेना	to take
इं	In
हुमेसा	Always
बोलिई	Speak
बेरा	Bera
स्टाइल	style
उचल	Pick up
सेफप	Safep
टोने	Tone
पाकिस्तान	Pakistan
एगईजर्जय	Agaijarjay
अब्वी	Abvi
हेहे	Hehe
चेन	chain
लखिया	Lakhia
सबे	All
आमीन	amen
बेचारिया	Poor
मफलर	muffler
नाहा	Naha
टोपों	Cannons
जेसी	Jesse
मार्णा	Marna
गैंट	Gantt
अबेय	Abey
भेजते	Send
रिंकुगजवानिकर	Rinkugajwanikar
नातुर	Natur
अक्षत	uninjured
बहग	Behg
जितना	as much a
हमाय	We
जायो	Go
मी	M
आणे	Bring in
डेल्ही	Delhi
मिलेया	Meet
जैयु	Jaiu
रहाना	Stay
पेज	page
ऐश्वर्या	Aishwarya
युआ	Yua
उपर	up
पकोरा	Pakora
पुछेगा	Will ask
खाचे	Eat
केतना	How much
पहली	First
बहटक	Wandering
उप	sub
बहादुर	brave
लेलोगे	Will take
भूमि	land
कोल्ड	Cold
आपसे	You
पारा	quicksilver
बत्यान	Tell me
पेलवान	Pailwan
पच्ताये	Regrets
आईईई	IEEE
बोल्के	Speak
रखी	Laid
कैसा	what like ?
चौधरी	Headman of a caste or trade or village
फ	The twenty-second consonant of the Devanagari syllabary
मौका	chance
समघ्ता	Understand
निवेदन	prayer
मोहबताइन	Mohbatain
पाए	Found
ड्रापन	Dropping
कामिने	Kamine
खो	dispel
फाड	tear
बनारे	Make
निर्भ्या	Nirbhaya
रहीन	Rin
गायिये	Cows
सालेसर	Salesar
मुल्लिया	Mullia
डबल	double
मिलायी	Mixed
आहे	
होया	Yes
अल्लेयस	Alleus
तक्षी	Takshi
गररर्र	Garrar
आंखिरत	Eyes
अगकारी	Agkari
मिच	Mitch
मिलेंगे	Meet
हंजी	Hanji
लड़कियान	Girls
उम्म्ममाह	Ummah
लेंगेनी	Lenny
चश्मा	spectacles
चक्मा	Chakma
योग्यता	ability
पटना	to be filled
अप्को	Apko
लिखी	Written
स्कूटी	Scooty
आलिया	Alia
कोरोरो	Kororo
असान	Asan
झकस	
जाय	Go
आर्य	Arya
नमबर्ग	Namberg
मज़हब	religion
पगल	Crazy
तमिल	Tamil
दर्ता	Darta
ख्याल	A mode of Indian music
ज़रुरत	Need
बुर्राह	Burrah
तोफासी	Tofasi
अर्शद	Arshad
नव्भारत्तिमेस	New Year's Day
रे	O !
आबटो	Abto
ब्नायी	Banai
जबाब	Reply
फाकू	Fake
वॉई	Wow
आमिर	Aamir
कुबोल	Kubol
गॉड	God
मुख्यमंत्री	chief minister
जलने	Burning
एफिल	Eiffel
होंगी	Will
उन्दा	Unda
कक	
घमंडियों	Pride
ग्रमी	Grammy
फ्रेंडस	Friends
बन्ने	Banne
पड़ना	to lie down
गांदू	Gandu
इंशालल्ला	Inshallah
बाब	The matter
चित	Lying flat on the back
रोतिया	Rotia
नाइटाओ	Nitao
अंगदाई	Angdai
सुरवत	Surat
पवित्रता	purity
फ्रल	Fral
लीय	
पटचलेगा	Will be found
सिस्टर	sister
लोप	vanishing
किस्मत	fate
खोर	lane
जमाने	Age
रहीम	the merciful
फोने	Phone
कामिनी	woman feeling sexual urge
आइफोन	iPhone
रिश्ता	relationship
समजेगा	Will understand
तगडा	fatten
मनकिंद	Mankind
साद	Saad
औरो	And others
सेर	ser
बोरा	gunny bag
निकालें	Remove
झंझनाहट	Hassle
देक्ता	Look at it
वलोकी	Valoki
मेरापास	Near me
भोजनी	Food
रामलीला	Ramlila
इतिहास	history
हारे	Losers
फदाह	Fadah
मुहुहा	Muhuha
चेए	Chey
चाहरा	Chahra
करंगा	Will do
सुत्रों	Sources
कोए	Coe
त्व	Tv
ड्रीम	Dream
करुंगा	'll
तल्लुक	Talluk
आँखों	Eyes
गाले	Galle
बानो	lady
देशद्रोही	traitor to one’s country
पाजी	low
हाइर	with respect
बिक्टी	Bikti
प्रीगंट	Pregnant
मैट	mat
योवा	Yowa
खेरा	small village
इतु	Itu
छीपा	Hidden
सावी	Savi
शर्माशर्मा	Sharma Sharma
एवर	Ever
बाकवास	Nonsense
पोद्दार	Poddar
चालुंगा	I will go.
क्या	What
तल	surface
फ्लो	Flow
टेयर	Tier
भिईईई	Brother-in-law
काश	denoting wish or desire
रंगे	Dyed
कमर	waist
वैस	By the way
लेडकी	Ledky
हावे	Hove
चिल्ला	string of a bow
भय्या	Fear
पाया	obtained
पम्पवा	Pumpwa
गंदा	dirty
स्र	
पवन	air
शाकल	Shakal
भारती	goddess Saraswati
खोकला	Cough
सॉल्यूशन	Solution
लौफेड	Lofed
आधरी	Half
फिदा	Floored
लिखनी	the act of writing
पिडलिई	Pidali
भाई	Brother
करदा	Tax
कहता	Says
बजप	Bajp
जिगी	
अगया	Agaya
बेटा	Son
खुवाब	Khwaab
बेहिसब	Unaccounted for
जावोगे	You will go
राजवीर	Rajveer
थीस	Thes
लोगे	People
रत	attached
बेचारी	Poor
बुखार	fever
किजियेगा	Will do it
इंसांस	Insans
दन	Loud report of a gun or cannon
सद्दा	Sadda
बेकॉस	Becos
ना	not
उराने	Urane
सोन्नच	Sonna
लेकुम	Lecum
खानदान	blood
तरजीह	preference
बागर	Bagar
दिख्ताय	Visible
खेलना	to play
जंजीर	chain
जाओगी	Will you go?
पातहा	Patha
होजाई	It's done
मुसीबत	calamity
जांदा	Janda
तेसी	That's it
न्ज़ारा	View
कुटिया	hutment
पैसो	Money
बुहुबली	Buhubli
वालेयो	People
बाद	later
हारू	Haru
काहे	Why
ठोकर	kick
वेंसीयो	Vencio
माजक	Fun
लोल	pendulous
इसी	this exactly
बोहत	Very much
लिखा	written
लूजर	Loser
हूव	Hoov
दोस्तियान	Friends
माउट	Mout
धानेवाड	Dhanewad
असल	real
सहवाग	Sehwag
अबत	Now
हमारीन	Ourin
मारते	Beat
हुमरा	Humra
राजिव	Rajiv
अल्लाइक्वेम	Allaikum
लागू	applicable
तेल	oil
इग्नोर	Ignore
चांटने	Chanting
लेखपाल	Village offical who keeps record
स्वगत	speaking or addressing oneself
जानता	Know
धुंधना	Fog
भाहुत	Bhahut
फोटोज़	Photos
यिप्प्पीई	Yippei
ओपन	Open
हिसार	Hisar
दफनाने	Bury
रहुंगा	Will stay
दुखी	sad
भायी	Brother
समझ	understanding
विकास	evolution
जॉरर	Jourr
भाओ	Brother,
चाहेये	Want
साउथ	South
सीधी	straight
परखा	Tested
शेतन	The Devil
मातरम	Mataram
मुझको	me
अत्म	ATM
रोना	to weep
तुमरी	You
राइंडी	Randy
लाने	Bring
कलर	Color
उदेगी	Will fly
कित्नखरप	How much
मुज्कोआ	Mujkoa
मत्रामजाई	Matramzai
इसिलिये	That's why
गालय	Galle
लेरा	Lera
सोजाओ	Go to sleep
चिपकते	Sticking
स्कोर	score
झुटा	Jhoota
गुल	flower
खुली	Open
हैशा	Hasha
जीतेन्गे	Will win
मिलकर	Consisting
जन्लोकपाल	JanLokpal
जाओंगा	Will go
दिखाना	to show
सूट	suit of clothe
आयेसी	Aai
जाउंगा	I will go
कर्नल	colonel
ख्रब	Poor
दित्तो	Ditto
दत्तक	adopted child
प्रोमिस	Promise
वल्ला	Valla
अबसे	From now on
दुबे	Dubey
मारू	killer
दखो	Look at
डेकी	Deki
मैचर	Matcher
बेट्टा	Betta
हाटे	Hats
करुंगी	I will do
निचे	Below
चुटिये	Chutye
थरकन	Tharcan
चुट्ये	Chutye
खाके	Template
एवेसोन	Aveson
कहन	Where
आजाये	Come today
इमानदार	genuine
मारने	Kill
किसके	Whom
टकलीफ	Trouble
जैनगे	Jainge
बेज	beige
रहेंगे	Will
मजेदार	funny
विभागो	Departments
दिलसे	From the heart
रसोल	Rasol
पेचे	Peche
संघर्ष	conflict
मान्यता	accreditation
शत	one hundred
लडकिया	Girls
टॉयलेट	toilet
प्धा	P.D.
अचेदीनागयेहई	Achedinagaye hai
विद्यालय	school
बिकिनी	bikini
पोहुँचायेंग	Will reach
मेने	I
पल्लू	border
जन्ना	Janna
सुन्ता	Sunta
कारो	Do it
असरा	Asra
दरिंदा	beast of prey
मगनरेगा	Mgnrega
खुद	self
इंडियाहट्टिक	Indiahattik
लेला	Lea
जलेबी	sweetmeat
उखर	Overthrow
पाध	Plant
बत्थक	Batth
राओयेगा	Raoyega
रान्ती	Ranti
कु	bad
अंडरवियर	Underwear
लिख	compose
रज़ाई	quilt
सैलून	saloon
म	The twenty-fifth consonant of the Devanagari syllabary
आपजी	You
टांडा	Tanda
भी	also
बर्रर	Barrar
वाल्ड	Wald
थामा	Stop
बैटोरने	Batorne
रविष्न्द्त्व	Ravishnitva
चुके	Have
एयरपोर्ट	airport
जाते	Go away
तत्व	element
सुरु	Start
अर्ज़	request
दिवाते	The diva
राख	ash
खुलासा	revealing
बक्त	Bakt
गाव	cow
घोटले	Scams
झुकवा	Bend
कहा	said
हुनेर	Huner
भाया	Brother
कीसी	Someone.
फर्म	firm
हान्न	Han
हप्पेन	Happen
प्रॉफिट	Profit
भोसरदी	Bhosardi
ब्रोसा	Brossa
डेरी	dairy
विनय	request
कप	Cup
पाशा	title of Turkish noble
वाओ	Wow
हंगे	Hange
पाये	Find
तेर	Yours
हाहाहाहाहाहा	Hahahahahaha
गाईई	Guy
वाट	watt
मूट	Moot
डम्बेस्ट	Dumbest
मिथुउउउ	Mithuou
बकरा	billy-goat
आजाताह	It comes
चायिये	I want
लादेनगे	Bin Laden
भाजरंगी	Saffron
जाएगे	Will go
आईयिई	Iyii
ओम	ohm
हुमरे	Humre
धरमसंकत्मेन	Dharamsankatmen
हाउन	Haun
पालडा	Palda
फरसाट	Farsat
मलम	Ointment
अड्ड्ड	Adda
साए	Shadow
आशिकी	Aashiqui
आमा	We are
शर्माजिरोक्स	Sharmajirox
लिवो	Livo
प्यार	love
अयेगाए	Will come?
दिख्ती	Look at it
पाएगा	Will find
नेपाल	Nepal
बरे	All right
धुंद	Mist
खासी	Sizeable
कबर	Grave
आदथ	Habit
धर्मशाला	hospice
मिल्ला	Milla
प्रधानमंत्रिजी	Prime Minister
शबाश	Well done
ज़रूर	Sure thing
उदाओ	E.g.
तभी	at that very moment
फेका	Throw it away
पूछा	Asked
आजकाल	Nowadays
अडव	Stop
खरे	True
बीट	droppings of bird
खान	mine
खोया	thickened milk product
डरने	Fear
जंप	jump
मिला	connects
जरा	old age
लकी	Lucky
आयशा	Aisha
लड़ने	Fight
सान	grindstone
गंदी	Dirty
बनती	Created
मेलोडी	Melody
गोत्ता	Gotta
कुशी	Kushi
सोकर	Soker
कलयुग	The fourth and last or present age
देवाना	God
गरीबगुय	Poor guy
घर	house
थाई	Thai
बाह	Bah
सलीम	Salim
लाकिन	But
मुझा	Me
मंगेगी	Will ask
गाए	Sing
कोमालिंसान	Komalinsan
अप्नो	Apno
अस्लामोलिकुम	Aslamolikum
कर्णा	Karna
ब्रणगी	Brangi
माह	the moon
सुजाव	Suggest
ख्वैश	Wish
की	possessive case-ending
ल्गायेगा	Will be installed
हिस्से	Part
मारो	hit
कार्नेवाले	Carneywale
नसरीगंज	Nashriganj
सुने	Heard
भेद	secret
धनय	Thank you
खीच	Pull
गिवे	Give it
तार	wire
चाय	tea
कैसे	How come
मुजेय	Me
जारी	continued
बजने	Ringing
नई	new
पौहचे	The pau
टूथटा	Broken
अम्मा	mother
दुसरा	The second
ताज	crown
पेडल	pedal
दुखया	Painful
चाते	Chaate
किसा	Who
सीन	scene
टिवेट	Twet
बाये	Left
पोस्टर	poster
हमलोगो	We
बज	Ringing
फालटू	Useless
दारे	Doors
पेन	Pen
किन	plural form of
हरणे	Losing
घटिया	inferior
इनहोन	Inhon
सच्चा	true
प्डेट	Update
दाखो	Look at
फड	Phad
मशल्लाह	Mashallah
डांढा	Dandha
वाजोद	Wajid
घुसु	Ghosu
सोचा	Thought
समर्थन	support
उदबिलाओ	Udbillao
खूबसूर्ती	Beautiful
मामले	Case
वतन	native country
विदेशों	Overseas
पहने	Wearing
किनरो	Kinro
इयमकृष्णम	Iyamkrishnam
जुडे	Join
परिणाम	result
करिये	Do it
सैटन	Satin
उत्ता	Utta
नागराज	king cobra
सल	sal
पाओला	Paola
दूसरे	secondly
फैला	spread
सकते	Can
खेलने	Play
पाहन	stone
रिप	Rip
भैजन	Brother
झूट	Lies
डेल	Dell
जुलाम	Oppression
दर्शन	seeing
समर्थ	capable
लप्पी	Lappi
चुराकर	Stealing
दयालु	kind-hearted
लक	luck
बटनाही	Not even a button
बुक्स	Books
झादी	Bush
खुशियान	Happiness
पहना	case
आनुमाति	Permission
जबर्जस्ती	Extortion
सहेरी	Saheri
गालो	Sing
सभी	all
मर	grudging
दियु	Diu
बदलेगी	Change
वेसभूष	Costumes
पामेला	Pamela
लड्डो	Laddoo
देन	act of giving
कामा	Cama
करु	Do it
व्यस्त	busy
जिस्मे	In which
पाणिगले	Water
पहचान	recognition
ढीला	loose
झंदा	Flag
ज़िंदगी	life
मानने	Acknowledge
उत्निही	That's it
चानव	Chanav
उठाओ	Pick
मास्टर	master
उठने	Get up
शर	arrow
विश्वरूपम	Vishwaroopam
कहिये	Say it
पैसों	Money
ग्येवी	Gyavi
माफी	excuse
गय्यय्यय	Gayayya
मैडम	Madam
लुविंग	Luving
बरताव	usage
शोमे	Show
रेहता	Rehta
जिम	gym
ऐसे	so
खाकर	By eating
कामी	lustful
रप्ली	Rapli
अजंगा	Ajaga
चुपके	silently
रुकेगी	Will stop
वेंट	Vent
जिईई	G.E.
आग्ये	Fire
सिग्नप	Signal
फ्रद	Fred
अव्व्वि	Avvi
जीती	Won
पुर	town
भेजती	Sends
गुरु	preceptor
ख्रीदी	Buyer
बेथे	Bethe
बिगाड़	defect
पनौती	Panauti
रोमल	Romal
म्हान	Mhan
धाम	abode
तम्हारी	Yours
उंक	
सेकटे	Secte
जेने	Jayne
कराने	To do
तनासाही	Tense
ओले	hailstone
माँग	demand
धोखा	fraud
छिये	Want it
शाउटिंग	Shouting
डिसकशन	Discussion
चाहते	Want
चलेया	Let's go
कदमो	Step by step
अनुमति	permission
बैठे	Sitting
लेकर	Ranging
खोना	to lose
नह	Not
सालमन	Salmon
कम्बख्त	Kambakkht
लूट	plunder
बतायें	Tell me
खादेर	Khader
पसीना	perspiration
उधार	loan
बा	Ba
श्रीधर	An epithet of Lord Vishnu
धोखे	Deception
छोड़	abandon
पोचोन्दो	Pochondo
अबकी	Now
द्र्कुमार्विश्वास	Faith in the world
इटब	Itb
लौंगा	Longa
दुर	meaning bad
बड़े	Large
खाती	carpenter
भैय्याजीस्पेक्स	Bhaiyajispecs
पडोस	environment
बुरा	bad
गोरिब	Gorib
चक्कर	wheel
ख्बी	Khbi
ध्कान	Dhkan
निर्णय	decision
दिलता	Give
अच्चे	Good
राधे	Radhe
फुचे	Fuche
मजाक	sneer
डिंग	Ding
मज़ाहबी	Religious
ईशा	Isha
कसना	to tie
डिब्बी	Box
दिलयांगे	Will give
लाइट्स	Lights
हुमेशा	Always
बटक	Butt
चुका	settle
दिला	Given
रेहमतकर्णा	Rehmatkarna
पासा	dice
कहानी	story
ऊर्र	Urr
अंखू	Ankhu
जयोगे	Yoge
भगेगा	Will run away
हार	defeat
खुनी	Murderer
पिस	Peace
आररी	Arri
बेक	Beck
सक्सक्स	Saxx
चोरी	theft
गाल्ट	Galt
जानेमन	sweetheart
तकात	In the form
कुफर	Kufr
दारू	medicine
ई	The fourth vowel of the Devanagari syllabary
मंग	Mang
गफ	thick
भाव	price
सुंदरी	nymph
रमेश	Ramesh
ताल्वे	Talvey
बेचते	Sell
ज़्ज़	zz
खर्ब	hundred billion
तुसी	Tusi
हक	stunned
फील	Feel
उठाना	to lift
गया	went
एप्पुडु	Appudu
जगेगी	Will wake up
लेग	Leg
लेनेका	Take it
कानों	Ears
आरती	ceremonial adoration of God
सहेनगे	Save
चालू	cunning
नमस्ते	Hello
दोस्त	Friend
परमार	Parmar
पिरोटे	Pirote
काना	blind of one eye
मैसट	Masat
बाडिया	Badia
लैब	lab
क्रन्गे	Krenge
गोव	Gov
छीनकर	By snatching
हमने	we
सौदागर	merchant
सुना	Heard
लोडो	Lodo
मनपासंद	Favorite
भाऊकाना	Brother
होवी	Howie
जाउन	Go
मृते	Dead
इस्की	Iski
अस्स्लमु	Assalmu
प्रकोप	violent anger
उड़ने	Flying
हाहाहाहाहहाहा	Hahahahaha
उने	He
मेंशन	Mention
बेवकूफ	You fool
कोहली	Kohli
देखा	seen
दाम	price
त्महारे	Your
गुज़र	livelihood
सम	even
राके	Rake
हाहाहाहाहहहाह	Hahahah
बेहेनो	Beheno
बता	show
दिवानी	Diwani
निब्ट	Nibt
पेहचान	First of all
कपर	Copar
असक	Asak
जौंगा	Wonga
शेख	sheik
खबर	news
खाया	Eaten
नेजिया	Nejia
बिघरत	Poor
गाटे	Sing
गीली	Wet
बुद्धे	The Buddha
बनवा	cause
माफ	forgive
अप	bad
लाउंडा	Launda
सटफ	Sutf
निकालिये	Get out
हिन्दी	Hindi
टूफनी	Stormy
यादे	Memories
लाइफ	Life
निभा	conducts
बनारा	Benara
हाठी	Elephant
समर	war
तोडियेगा	Will break
पाकडे	Paka
शिवितुकरल	Shivitukaral
नोटंकी	Note:
मुंबईकर	Mumbaikars
बेताब	powerle
कुसोर	Kusor
मगर	crocodile
थक	Tired
आखिर	tip
पाव	fourth part
साड़ियों	Sarees
फ्राह	Farah
खेती	husbandry
इक	prestressed form of
था	was
ब्रेथिग	Brathig
द्रंक्विनोदमेहता	Dr. Quinodmehta
कैच	Catches
वादे	Promises
श्मझते	Shmita
वार	Any day of the week as
आयोग	commission
बरदाश	Toleration
खातम	End
गैस	gas
फ्ट	ft
बोट	boat
गुए	Gue
सरदी	winter
आईईईईईई	IEEE
फकर	Fakar
भैय्या	Brother
इपल	Ipal
तुजसे	From you
हिस	His
डरर	Darr
जानमा	Jaanma
उरिया	Uria
एवेसोम	Avesom
विनर	Winner
घोसित	Ghosit
सामर्थ्यवान	Powerful
उष	Ush
चढ़ता	ascending
अरेय्य	Hey,
हट्स	Huts
मोहल	Mohal
पार्ट	part
पवित्र	pure
गेस	Gass
झिंड	Jhind
बहिजान	Bahijan
आव	Aav
अप्पा	Appa
कोंट्रा	Contra
रिश्वत	bribe
ताक	look
अभिई	Abhi
गत	gone
बॉडीगार्ड	Bodyguard
राघव	An outstanding scion or descendant of king Raghu’s dynasty
सुकर	easy to do
पायरे	Feet
ममताजी	Mamataji
पटियाला	Patiala
एही	That's it
मुज	Me
आपलॉग	You log
लालन	caressing
उसके	her
चांगे	Change
जिई	G.I.
मिंग	Ming
भालये	Well done
इंके	Inc.
प्रति	for each
इश्का	Ishka
रहेगा	Will
चोल	Chola
हल्का	light
बंदेगी	Bangi
शमे	Shamme
इन्ही	These
जंवर	Janwar
नेताजी	netaji
दियान	Dian
सोवार	Sowar
जामा	robe
स्म्भलगे	Understand
लीफ	Leaf
मोटे	Coarse
ऑनो	Ono
खेते	Farm
ब्ला	Blah
फेक्ते	Fake
बहोत	Very much
जिया	Zia
टुउन्गे	Tunge
मेहु	Mehu
भरे	Filled
धुम	Smoke
नहीई	No,
ट्री	Tree
दिखाई	showing
मोज	Moz
आचा	Acha
मारखने	Marne
उदायेगा	Will rise
एस्का	Eska
पिछ	Behind
पैड	pad of paper
वाइसाबी	Waisabi
जियो	Live
कज	crooked
गटोरडे	Gatorade
टोमोरो	Tomoro
बक्वास	Bucks
बिन	bin
मलेगी	Will you get it?
पटाओ	Patao
धक्कन	Shock
बन्ना	bridegroom
पायसा	Paisa
प्ध्ती	Method
जिसे	That
दिबांग	Dibang
गौटी	Gauti
माइली	Miley
प्डाई	Reading
देकनी	Look at it
लक्ष्मी	Goddess of wealth and prosperity and wife of Lord Vishnu
फाले	Falley
जा	Be off ! get away !
शीद	Sheed
नामोमागिक	Name
आइये	Let's
होन्हार	Promising
मीठा	sweet
तुम्हारा	your
अम्मी	mother
डिलीडेसाइड	Delideside
जनता	public
किस्पे	Kispe
इस्पे	Ispe
परसाद	Parsad
ढूँड	Find out
थार्रा	Tharra
आउट	out
क्व	
अधिक	more
चरे	Fodder
पैकेट	packet
केजरीवालजी	Kejriwal ji
उनके	Their
एक्चेदिन	Exchedin
गल्ला	flock
नौटंकिबाज	Gimmicks
जैसी	Like
बीफिया	Bifia
समझा	I see
सीखी	Learned
यानी	that is
गालियो	Galileo
के	Case-ending showing possession or relation
नीद	Need
निकलेगा	Yield
ट्यून	Tune
सुन्ना	zero
कुशवाहा	Kushwaha
केम	Cam
बुने	Weaved
तुंगदेखराह	Tungadekhrah
घूमने	Roam
मैंडते	Mandate
लेखे	account
चीथी	Chit
पिस्टल	pistol
बहता	Flows
सही	right
बायें	to the left
मिटाओ	Delete
बैजत	Badge
शुआक	Shuak
फोन	Phone
प्रॉयजों	Projon
बोना	to sow seed
बॉय	Boy
सिल्वा	Silva
निरालेय	Unique
पहुचाया	Arrived
सत्ती	Satti
बदले	Instead
अतंक्वादिको	Attankadiko
पहोच	Reach out
सनमान	Sanman
नेही	Not
अक्सर	often
मेहकी	Mehki
ज़लक	Zalak
इला	Ela
कराडे	Do it
अतलजी	Atalji
राहोज	Stay
ढाल	slope
बन्धना	Bondage
भीख	begging
तोड़ा	scarcity
दबे	Buried
रक्षा	protection
ह्राने	Loss
कियू	Why
तुनय	You are
चटनी	Sauce generally of mint leaves with salt
मैसगथेफ	Massathef
फेव	Fave
अंग	limb
हाफ्ता	Week
थोराई	Thorai
नमर्द	Namard
योगी	yogi
किधा	How much
आम	Mango tree as well as fruit
सन	a kind of jute
चूर	small pieces
जोई	Joey
सूझता	Suggestion
फरिस्ता	Farista
पुंच	Punch
ली	took
दते	Date
भोपल	Bhopal
डाला	Large branch of a tree
दनियाफ	Danyaf
क्रने	Krne
धुंध	mist
श्री	Lakshmi
उत्ना	That's it
हेल्लू	Hello
हिलो	Hilo
एलाइकुम	Alaikum
दोनों	both
अस्सलमु	Assalmu
लिकी	Liki
नीचे	under
बेटी	Daughter
मफ्क	Mafk
रेखलो	Rekhalo
वीर	hero
माजबूरी	Forced
भाऊ	Brother
पिडल	Piddle
स्ब	SB
फित्रत	Fitrat
जिस्को	Which
त्भी	Then
आपने	You
कुमारगुद्दु	Kumarguddu
डाइना	Diana
बहेन	Bahen
आऊ	Come on
ओक्सोरी	Oksori
प्रर	P.R.
क्नफेसन	Confesson
नाहनी	Not at all
नींद	sleep
अकेला	single
साब	Saab
मज़बूर	Forced
तड़पा	Craved
रग्गा	Ragga
तत्तय	Tatya
हज	pilgrimage to Mecca
करवाल	Nail of the finger or toe
पड़ेंगे	Will fall
मदाद	Help
सीवाई	C.Y
किसलिये	Why
डीटा	Data
इसलिये	therefore
प्लेन	plane
त्रक्की	Trick
होफा	Hoffa
बंगया	Bangaya
उत्तर	north
वेस	Wes
फ्रॉड	Fraud
हईई	Hey
सादत	Sadat
पौसे	Pause
मोरे	More
हैरान	astonished
मेनेगा	Menega
मलका	Malka
देखले	I saw
मुर्खों	Fools
डालने	Insert
अटक	bar
पाधनी	Reading
बावजूद	In spite of
उपररर	Above
पहुचने	Reach
भेज	despatch
पारवर्डीदार	Parwarddar
साड़े	Plain
उउय्य	Uyuyya
बच्चे	children
मुझे	me
फारौतख्तार	Farotaktar
किया	Be
दर्द	pain
न्यू	gnu
लोंडा	Londa
सलोक	Salok
चुनी	Chosen
आँधी	duststorm
एहा	Ah,
वूउ	Wu
डोवाये	Doveye
येपी	Yepi
माआ	Maya
जीवन	life
स्टॉप	Stop
महा	great
एंडर	Ander
पायेगी	Will get
लहराया	Waved
धामा	Dhama
बैंगन	brinjal
सुरक्षित	safe
गारा	mortar
चल	movable
सारे	All
रहेगी	Will
पगालो	Crazy
डेलेगा	Delega
अफ्फ्फ	Afff
ज़नत	Janat
जाघा	Place
पायेंगे	Will find
पप्पी	Pappi
कमली	light or small blanket
मोम्बत्ती	Candle
माले	Male
गला	throat
यपा	Yapa
जुमला	sentence
थेरे	There
छ्टिया	Ch.
रह	way
राजी	line
पाकौ	Cook
सागरीकघोष	Sagarikghosh
पवर	Power
लगाया	Imposed
लाखो	Millions
बाप	father
पर्म	perm
बाटिएन	Batien
वाहेगुरू	Waheguru
कार्दो	Cardo
काला	black
श्याद	Shyad
तिओ	Teo
धमाल	a mode of music
सोते	Sleep
रुस्कूओ	Ruskuo
रुलाने	Crying
जीकर	Jikar
ज्येगा	Will go
चौर	Chaur
ज्वंगे	Jungle
होजाये	Be done
फेस	Face
चोके	Choke
एमोतनल	Emotanal
सोम	the moon
माला	rosary
कामज़ोर	Weak
कहो	Say
खुदके	Own
राचा	Racha
विन	Win
नहीं	No
सहारा	support
ओ	The tenth vowel of the Devanagari syllabary
भगोदा	Fugitive
चड्डी	lower under-garment
बतडुंगी	I will tell you
मचायेगा	Will make a mess
साठिया	Sathia
पैराशूट	parachute
जायेज	Valid
मिसाल	example
पेध	Tree
सीक्रेट	Secret
ह्मेसा	Always
किरिट	Kirit
इंसान	human being
शीन	frozen
कर्ताहु	I will do it.
लगेगी	Will it take
दूध	milk
डीगे	Dige
बताए	Described
बेहजा	Behja
चारो	All four
पेल	shove
सांस	breath
सुधीरतईलंग	Sudhirtitlang
कहोगा	Will say
समाज	society
वासे	Wase
एक्टिंग	Acting
डर्जा	Fear
रम्मी	Rummy
शोपिंग	Shopping
शाहरुख	Shah Rukh
चुराय	Theft
सरकार	government
द्वारा	by
मनीष	Manish
मालगाडियो	Freight trains
ब्टन	Bton
लूल	Lule
हुडा	Huda
बैंकॉक	bangkok
केरिंग	Kering
हैंठ	Hand
दयरा	Daya
लमाओ	Lamao
खुशियो	Happiness
राफा	Rafa
बैजान	Baijan
एक्च्चे	True
मुम्मा	Mumma
सम्भोधित	Addressed
दुश्मनी	enmity
मुल्लो	Mullo
डालना	to throw down
मधर	Madhar
बजा	fit
कसमीर	Kamir
भौक्ति	Physics
लेड	lead metal
धोने	Wash
खाना	food
छोरी	lass
मेहनती	laborious
ह्यूमर	Humor
बोले	Snapped
अंदाज़	rough estimate
बीत	Passed
आएसी	IC
बलगाम	Balgam
लिखने	Write
फास	Fas
सलगीर	Salgir
नाऊ	barber
सब्सिडी	Subsidies
एम	A measure equal to 1/6 inch
मशाललाह	Mashallah
शमिताभ्त्रेलेरलौनच	Shamitabhtrelerlon
अंतेरात्मा	Conscience
मुशलमान	Mushalman
आनेवाला	coming
चोरा	Thief
किचते	Kitty
जैये	Go
राखोगी	Will keep it
देखुंग	Look at it
कैंटीन	canteen
भीक	Begging
लता	creeper
फेल	Fail
येही	Here too
बॉयज	Boys
भे	Send
कमिटम्ट	Commitment
कुरान	the holy Quran
लागा	
केर्न	Kern
कार्ते	Carte
तेलवाले	Oil people
इंग्लिश	English
जुटा	muster
हमला	attack
बोलथा	Speaking
खाली	empty
रखेया	Keep it
जेक	Jake
गल्टी	Mistake
मालूम	known
बाहप	Bahap
अव्व्वे	Avve
बरेम	Barem
अब्प	Abp
डम	Dum
स्किट	Skit
रक्खो	Keep it
झुनजुनु	Jhunjunu
झूठी	False
वाल्की	Walkie
दीवाने	Crazy
बाजा	musical instrument
बेटे	Son
संगस्थान	Place of Association
बारा	bout
जादा	More
साबने	All
दता	Data
वर	boon
सारी	All
उच्चालो	Pronounced
जिस्पे	Jispe
जलिन	Jalin
रेला	flood
याओ	good
तत्काल	at that very moment
बागल	Bagal
किलास	Fort
मजी	Maji
थाट	That's it
तुम्मारा	Yours
देकर	By
डांसर	Dancer
चेयर	Chair
जमाये	Deposit
षत्युव्मा	Shatuvma
भाइजान	Brother
नमक	salt
डेनवाल	Denval
खोखली	Hollow
राजेस्थान	Rajasthan
असलाम	Aslam
आँखें	Eyes
खायी	Eat
काई	water-moss
मॉर्निंग	Morning
फैलता	Spreads
जिदा	Alive
सैनिक	soldier
गाओ	Sing
सबस	All
पोचा	Pocha
अवल्स	Awles
हसरत	longing
तस्वीर	picture
सिर्फ	alone
घास	gra
अनेक	more than one
दीख	Look at
फेन्स	Fans
जानुअरी	Januari
हत्या	murder
मिल्टा	Milta
सम्भाल	Take care
बुना	Woven
उल	Ul
लूटा	Robbed
आनु	Anu
दूसरी	Second
करनेवाला	Doer
साथियों	Peers
मोधी	Modhi
लड़की	The girl
झाड	whisk
जायदा	More
खेलें	Play
वालेकुम	Walekum
वेगवेगवेग	Velocity
सिखना	Learning
लिखू	Write
ज़माना	time
क्यूंकी	Because
स्वाद	taste
चुड़ा	Chuda
सजा	punishment
जी	Yes
अरेय	Hey
खातू	Khatu
स्कते	Skate
कुमार	prince
हालत	state
वा	or
चार्नन	Charnon
युवाओं	Youth
सोये	Sleep
शम्झो	Shamzo
शर्म	shame
ख्र्ल	
पटने	Patne
चुलबुल	uneasiness
घटना	event
पार्स	Parse
इम्प्रेस	Impress
भीन	Bhin
पागल	mad
पिछ्ली	Previous
हुए	Happened
ओरजान	Orjan
वेडनस्डे	Wedsday
बिबियो	Bibio
बीटे	Beta
लाडो	Lado
मनाये	Celebrate
कमन्त	Low
सकल	gross
कार्येकाल	Tenure
जन्हित	Born
दिखानी	Show
रापत	Rapat
प्क्कका	Pakka
उप्पर	Upper
अंधा	blind
जान	knowledge or information
गोपाल	cow-keeper
मूवी	Movie
कबूतर	pigeon
पेहन	Wear
शत्रछाया	Enemies
कदो	Kado
अजीब	wonderful
सीड	Seed
आमादमिकिसरकार	The Government of India
लोगो	logo
अक्का	elder sister
बैथ	Beth
कोंग	Kong
चुड़	Chud
मरना	to die
हरकटी	Movement
शिकार	prey
नैनसाफी	Nansafi
दुख्ती	Pain
मुंह	mouth
इबाद्त	Worship
अकम	Akam
लाइक	Like
उस्सी	Ussi
शिंदे	Shinde
टेक	prop
अमिताभ	Amitabh Bachchan
ठट	That's it
आरी	small saw
मार	Cupid
बाली	earring
महिलावों	Women
इंतेजार	Waiting
इयूल्यूहाओक	Iuluhaok
भूहू	Bhuhu
पड़ा	laid aside
चेले	Disciples
बस	Bus
बैठी	Sitting
औंगा	Aunga
महीना	month
कुड़ने	Jumping
यरर	Yarr
लेक्स	Lex
भोक्सदा	Bhoksda
रहता	Lives
जैगा	Wake up
मिलोन	Milon
सबी	All
बिजान	Bijan
अंबानी	Ambani
गम	gum
मिली	Found
केर्टी	Kerty
माही	fish
बचा	escape
भाइयों	brethren
छेरे	Chhere
घटनायें	Events
अपकी	Yours
भाले	Spears
पागले	Crazy
यात्री	traveller
बेलीवे	Belloway
आजाओ	Come on
आयसा	Aisa
ताकली	Takli
ओविसे	Ovise
फेले	Failed
राहता	Stay
कशिश	attraction
अप्डिये	Apdiye
राहू	Rahu
एकडम	Absolutely
बहुमत	majority
समाज्जाओ	Understand
उफ	Oops,
स्वगथ	Welcome
कार्था	Cartha
द्र्शन	Vision
सिटी	City
तारानाम	Taranam
हजीर	Hazir
अरबिंद	Arbind
सुन्ते	Sunte
किई	Kii
ब्र	B.R.
दुकानो	Shops
जायेंगे	Will
लागये	Got it
हसलम	Haslam
टोडके	Todke
नक्से	Maps
राखोगेजरा	Keep it
बाल्की	Balki
कृष	Krish
मेरा	my
मुस्किल	Difficult
देखाई	Seen
संगत	company
कोय	Koy
बाल्म	Balm
कुंबा	kinsfolk
आजादी	freedom
सारल्ली	Saralli
विधान	arranging
हिहिही	Hihihi
आसाइया	Asaiah
जरुर	Must
दिख्ता	Look at it
क्रदो	Do it
स्वच्भारत	Clean India
स्मिलिंग	Smiley
इंट्यजर	Integer
मेल्जोल	Interaction
पहुच	Access
राहकता	Stay
शक्तिशाली	potentate
जितेगा	Will win
चूउथ	Chuth
गायराही	Missing
अथन्निया	Athania
खेल	game
देखे	Viewed
तुम	you
बहाउत	Excuse
पीन	fat
बिपाक्षा	Bipasha
कुत्त	The dog
ज़माना	time
चैनल	Channel
माफिक	Mafiq
चूड़	Bangles
सभे	Meeting
आपके	Your
दुवाये	Links
पंखुरी	petal of a flower
पटली	
लागते	It takes
बोर	a dip
टोपे	Top
वलोबसी	Valobasi
मोझ	
थिंग	Thing
छाड़ी	Stick
दिज्ये	Give it
बेवडे	Bevde
केरा	Kera
कुवारा	Kuwara
आगरा	Agra
नाइक	Naik
ग्रेसी	Gracie
बोलेटो	Boleto
बैकचोडी	Backchody
परेशान	confounded
न्यूज	News
किप	Kip
प्ले	play
बिचरे	Poor
ह्लो	Hello
बुखारी	silo
शांत	cool
डर्ते	Fear
अछे	Good
लेनी	Seek
ग्वा	Gua
गाढो	Donkeys
मए	Mae
धक्के	Shock
औलाद	progeny
मज्से	Majse
उतरवता	Landing
नीलम	sapphire
फरमाईश	Farmaish
ज़लिल	Jalil
चुनावों	Elections
लेलिया	Leliya
हहाहा	Hahaha
इंका	Inca
पाढले	Read
आवसम	Avsam
ज्येनगे	Jyenge
हमरी	Ours
इस्पार	Ispar
मस्धोनी	Masdhoni
कराइन	Karen:
चेला	disciple
सीस	head
बुहत	Great
रम	rum
गद्दार	quisling
बातें	Things
आसु	Tears
वोह	Wow
भगौ	Run away
हीई	Hey
स्ट्री	Stree
चलाही	Walk
फरज़ीवाल	Farziwal
मेल	connection
मुरली	flute
ऑफ	Of
उडबिलाओ	Fly
डेमाग	Demag
आलसी	lazy person
रंग	colour
रखे	Placed
स्वगट	Swagut
जलसे	From the water
भेजी	Sent
नक्को	Nakko
गौतम	Gautama
खिलाड़ी	player
बकवास	
ती	She
करेन	Karen
खोइलुंगा	I will lose
खोलुंगा	I will open
नही	No
हरमपाना	Harampana
क्यो	Why
पंक्चर	puncture
ताज़गी	freshne
भरस्टाचार	Corruption
रोकना	Hold up
अकसले	
करवाया	Orchestrated
सनल	Sanal
होलिबस	Holibus
हारी	Hari
रहामाई	Rahmai
फॉर्मेट	Format
जाब्र्डस्थ	Jabrashth
क्योकी	Because
पुरुस	Male
काटुओ	Katuo
क्रिकेट	cricket
उन्हे	Them
कियो	Why
हध	Hadh
ओनली	Only
नागपुर	Nagpur
मुंबर	Mumbar
पड़ेगी	Will fall
ह्र	
आशीष	Ashish
छ्लता	Cheating
नूर	light
मोहोब्बत	Love
ठरु	
तलाश	search
लुभा	Tempting
व	The twenty-ninth consonant of the Devanagari syllabary
उनका	their
खाड़े	Standing
भैठो	Brother
किसने	who
उतारते	Downs
राजन	Rajan
हल्के	Lightweight
देहली	threshold
होगेया	Will it happen?
सम्झा	Samjha
उन्हो	They
यह	this
अनुग्रह	favour
बाकी	except
भीड़	crowd
नाशीनो	Nashino
एह	Eh
मैंने	I
शर्मनाक	shameful
लोगू	Logu
पिलाव	Baby
सेंड	Send
लिखता	Writes
जायेंगी	Will go
उ	The fifth vowel of the Devanagari syllabary
हद्द	Limit
माहोल	Atmosphere
बोर्डर	Boarder
रेह	alkali or brackish soil
जाआ	Go
रेल	rail
हत्ते	Hats
लीआ	Leah
चेगे	Chege
गजाब	Amazing
करवाके	Get it done
खाडे	Standing
लगोज	Lagoz
आपका	your
अपनाओ	Adopt
गाली	abuse
साकी	saki
हरवा	Lose
युद्ध	war
ब्कक्यूहल्सिक	Bakkullsic
भुके	Hungry
पर्हताय	Parhatay
टोटके	Totke
सुन्चिकापन्डे	Sunchikapande
बादाओ	Badao
केया	What
बैट	bat
भग्त	God
ब्रेक	Break
अंग्रेजी	english
बीकुफो	Bekufo
असलम	Aslam
तोडुंगी	I will break
इज्जत	honour
सके	Can
क्रिकेट्सगर	Cricketsgar
एल	el
जूता	shoe
सेरा	Serra
अरिहंत	Arihant
दीखती	Looks like
हम्पे	Hampe
मेहँगा	Expensive
अगाई	Agai
प्रीति	affection
इल्म	knowledge
सुनाई	hearing
वक्त	opportunity
न्जर	Njar
कहेने	To say
लूग	Lug
रहते	Live
टमहे	You are
साइड	side
पुच्ती	Poochti
प्यारी	darling
कोई	so
इक्से	Ikse
पैगा	Paiga
खरीद	buy
समुंदर	sea
प्रिया	darling
लिंग	male genital organ
हातौ	Hands
बोलिया	Bolia
खूबसूरती	Beauty
लगेंगे	Take
फॉर्मूला	Formula
दप	Sw
जिन्हे	That
ठिक	proper
सरब	Sarab
कुउउहराए	Why
ओढ	Draw
प्राडर्शन	Presentation
अफरन	Afran
ईमानदार	honest
अकीब	Akib
उटारो	Utaro
रेकॉर्ड	Record
काहू	A hardwood tree Lactuca sativa
मित्रा	Mitra
रब्बा	Rabba
हज़ार	one thousand
नकाम	Failure
एडमिट	Admit
सुबह	morning
अति	very much
कमाओ	Earn
देखोंगा	I will see.
हेड	head
हबितनी	Habitani
हिला	wave
खेलोडुमलागके	Play games
होथा	Hoth
दिखाया	Shown
कचरे	Waste
भासन	Bhasan
जाएँगी	Will
एसे	Such as
असर	effect
माइन	Mine
क्रिकेटकॉम्पेरे	CricketCompere
मादा	female
करणी	surd
ज़्माना	Zamana
बदत्त	Big
परसन	Person
अनहोन	Unborn
उआल्लू	Uallu
बेनाना	Benana
झादू	Broom
पक्ष	side
भाइजा	Brother
इतनी	So
क्रवाग	Kravag
हरवाने	Losing
नामा	letter
थम	stop
त्कजबक्पिअत	Tkjabakpiat
हांसी	Laugh
जागरुक	awake
चोकी	Choki
जिये	Live
ताकदीरवाला	Takdirwala
मुंचें	Stage
चदनेवाला	Climber
केजरीवाल	Kejriwal
शोना	Shona
जेस	Jess
भारमिनी	Bharmini
मुकेश	Mukesh
हुउउ	Huu
बातांगा	Batunga
काड	cod fish
सुन	hear
असलामुअलेकुम	Assalamualaikum
जैयो	Jio
स्टैंड	stand
लूटाई	Robbed
पित्ना	Beating
वाराणसी	Varanasi
खैर	the tree acacia
नासा	nose
जियोहाजरोसाल्कव	Jiohajrosalkov
पंचोली	Pancholi
कर्नाटका	Karnataka
माया	illusion
राहा	Stay
बनवाये	Made
भार	obligation
डुपर	Duper
दिलवाते	Gives
आगिया	Agia
पूचा	Pooch
चेतवनी	Warning
लुब	Lub
कार्के	Karke
सभयता	Fear
बचना	to be saved
हुमी	Humi
जोश	zeal
मस्ती	drunkenness
गॉट	Gott
दुस्रा	The second
मुगेरीलाल	Muggerilal
रोज़	everyday
कहताई	Says
बालकुम	Balakum
कोज	Coz
शामत	bad luck
बरबर	Barbar
लाख	lac
माने	meaning
कुंजियान	Keys
होप	Hope
क्लास्माई	Classmai
पाक	pure
जलते	Burning
साकू	Saku
तुल्लू	Tulu
गोन	sack of grain
घुमटे	Ghumte
जहा	Where
पकरू	Pakru
टकर	Tucker
दूदर्शिता	Foresight
य	The twenty-sixth consonant of the Devanagari syllabary
साचा	Sacha
बाथ	Bath
वीर्पलबाथिंडा	Virpalbathinda
अक्षिता	Akshita
सीखना	To learn
गेट	gate
सिखो	Learn
देशोभा	Country
डालकें	Put in
बाचा	Bacha
युग	pair
सर्ग	canto in an epic
च	The sixth consonant of the Devanagari syllabary
बुलायें	Call
खात्म	End
जलदी	Fast
अर्थत	That means
जैहो	Jai
अह	Ah
देखनी	View
विट	Witt
फुटेंगे	Will burst
टुनी	Tuni
आदमी	man
काम्बख्तो	Kambakhto
नहे	Not
मना	forbidden
बनाना	to make
जायिये	Go
आलू	potato
अक्टोबर	October
निब्जीत	Nibjit
होचुकी	It's done
मुल्ला	Muslim priest
साराह	Sarah
चाला	auspicious moment of departure
हमेसा	Always
ट्रू	True
कब्जा	hinge
अलावा	moreover
डम्ब	Dumb
येतो	Coming
आफत	pain
मिज़ाज	nature
रोकी	Stopped
रहताहु	I live
वर्ल्ड	World
शेर	couplet
टेडे	Tede
झुकना	to bend
बदा	Big
फाटा	Cracked
क्रुगा	Kruga
मैग	Mag
लेजये	Take it
आवाज़	voice
सद	Sad
किराया	rent
पुर्ण	Complete
फरज़ी	Farzi
बिल्डिंग	building
बट	Twist in a rope or string
गाड़ी	cart
अलसी	linseed
जितेगी	Will win
ठंडी	cold
देखी	Seen
यार	friend
जिसके	Which
सुचिई	List
बॉलीवुडकालिंग	Bollywood Calling
फी	Fei
ग्लोव्स	Gloves
बरबादी	ruin
बिखर	Shattered
नगर	town
उन्नारू	Unnao
ऐप्को	Apco
पैट	Pat
ओए	Oy
लगभाग	Approximately,
प्रतियोगिता	competition
ऐशराजावत	Aishrajawat
दिल्लीबासी	Delhiites
नकफफतन	Cash
हम्मे	We
खिलारी	Player
चोर्ड	Chord
असिर्वाद	Ashirwad
सूरत	countenance
शाम	Evening
भिजवा	despatch
शुद	Pure
दिखाते	Show
तैयर	Ready
सॉरी	Sorry
यायरो	Yayro
फीलिन	Phyllin
अताक	Attak
जयराम	Jairam
डूब	Depth or place enough for drowning
खिचेगा	Will pull
चैट	chat
लुंच	Lunch
पड़ेगा	Have
फेक	Fake
मॉम	Mom
क्वी	Qui
कैटी	Katy
सज़ा	punishment
डेर	Der
ममद	Mamad
खर्चा	payment
कमलेश	Kamlesh
फ्रुस्टेट	Frustat
असही	Not right
ओरिचय	Orichy
छुपाने	Hide
पराग	pollen
पके	Ripe
कंबल	blanket
सुधरोगे	Will improve
दौर	circle
टेरिशे	Teriche
भाईजाई	Brother
धोका	Danger
सुपरहिट	Super hit
हिमत	Himat
कराची	Karachi
साला	Brother-in-Law
खेलो	Play
करना	to do
चक	large plot of land
ब्लॉग	blog
पेदाईश	Pedaish
हसिल	Achieved
द्रमेबाज़	Drummer
तुतना	Tutina
जितनी	As
कण	particle
संस्या	Problems
गू	human excreta
टोच	Toch
मुहुम्बत	Mohabbat
चा	tea
सुनाओ	Listen
टैंक	water tank
पुचे	Ask
साइज़	size
आएगी	Will
समर्थक	seconder
उस्पर	Usper
लगाटर	Lagter
जाऊ	Let's go
किरेन	Kieran
निकलने	Get out
भरतभियाँ	Bharatbhaiyan
तिवारी	ti
घर्मे	At home
डार्न	Darn
वीड	weed
आल	All
हैं	Hey ! stop that !
सीट्स	Seats
डिडेज	Didage
नतीजे	Result
ओरिजिनल	Original
गाने	Songs
गिरने	Falling
आसा	Asa
ब्ध्या	Midday
जदू	Magic
सक्सेनानुरग	Saxena
खाते	Account
आप	self
बहास	Debate
साधी	Simple
जेटेंज	Jettenz
आओ	Come
खिलवाड़	play
आतंकी	Terrorist
मे	In
डूबेगी	Will drown
तुहाडे	Your
हुन्न	Hunn
ब्तमीज़	Btamez
शाकाल	Shakal
रामदेव	Ramdev
मिलू	Meet
खेलाओ	Play
हंन्न	Hann
पेहन्ते	Wear
चाहियाए	Want it
शर्मा	Sharma
आदब	Adab
राजनीति	politic
चोडु	Chodu
भार्वा	Bharwa
फोटो	Photo
मोहल्ले	Neighbourhood
दुसरो	Others
डेग्रासी	Degrassi
भूख	hunger
हाउगी	How will it be?
हक्क	Right
फ्ले	Flay
गड़ी	Gadi
बंदे	Fellow
स्म्पली	Smpley
वाकिफ	Aware
बैजन	Baijan
करोगे	Would
विन्ती	Request
झुऊत	Jhoout
छुटकला	Escape
अनकल	Ankal
रखो	Keep
बारी	time
लाडिया	Ladiya
कछुआ	turtle
बिरयानी	biryani
बनवाने	To build
पटखाय	Crackers
रिस्पेक्ट	Respect
आर्यभट्ट	Aryabhata
वाता	The wind
हहाहाहा	Hahahaha
भाटिजो	Bhatijo
जुनून	madness
मेज़े	
करोन	Karon
आइंट	Aint
येमैन	Yeman
फिल्म	film
ईतो	Eto
सोभी	Sobhi
इफ	If
पहचानो	Recognize
भैयो	Brothers
पूछो	Ask
पार्सन	Parsons
एक्साइट	Excite
विश्वास	faith belief
पेप्सी	Pepsi
क्लिक	Click
खोलेंगे	Open
बजय	Instead of
मस	Hairs on the face which appear first in early youth
ख्या	
मन्ने	Manne
दाकार	Dakar
कूडते	Jumping
बटलता	Batta
लिखना	To write
अकबार	Akbar
शान्दर	Beautiful
बनालो	Make it
लगताहाई	Looks like
पापाओ	Papa
कमाई	earning
टोनिघ्त	Tonight
कन्यादान	Giving away one’s daughter in marriage
चामरा	Chamara
कफी	phlegmatic
पिनी	Pini
बलकुल	Balkul
हर्कटेन	Harkten
लैगबाग	Lagbag
बाज़ी	game
हटके	Away
वोट	vote
कहेन	Say
क्रोर	Krore
सिखेर	Sikher
बाचो	Save
फॉर	For
गैप	Gap
औरत	woman
कोर	point
प्यास	thirst
भरोसे	Trust
देक्ति	Decti
फ्री	Free
ऑर्टो	Orto
मातलब	Meaning
बाटा	Bata
बिहारित्वीतर	Non-Bihar
भें	
नाइट	night
मन्ट	Mant
चीज़	thing
दहिया	Dahiya
अनोखा	strange
राफु	Rafu
दिल्लीवाले	Delhiites
ल्यो	Lyo
अवल	Aval
महारानी	The principal wife of a raja
पालिका	ear-lobe
काकर	Kakar
पैसी	Pacey
कनाडा	Canada
केसेहे	How is it?
नरन्द्र	Narendra
सलुते	Salute
खिलाने	Feeding
अके	Ake
मदरचोड़	
बटाउ	Tell me
डोंगी	canoe
कैसेन	Howsen
वटवर्ण	Whites
ज़रुरी	necessary
जेहमत	Courage
कार्टून	cartoon
होजाइगी	Will be done
कुवारी	Virgin
अपो	Apo
धंधा	occupation
माता	small pox
अप्राध	Uncommitted
उच	High
मेगलाय	Magalai
बिचारा	without any resource
सेखों	Sekhon
लखनऊ	Lucknow
इशांत	Ishant
जिमी	Jimmy
बोझ	burden
लड़के	Boy
हुये	Happened
लाठी	long steff
केसा	How
फराह	Farah
बात	talk
अकाल	famine
सबनी	All
रफ्ता	Rafta
ब्टायन	Tell me
देदे	Give it
बॉडीगर्ड	Bodyguard
गुड़गांव	Gurgaon
खबीस	Khabees
कागता	Kagata
सफर	journey
सीना	to sew
शर्मके	Shame
खनानी	Khanani
कोडबेस	Codebase
अगी	Fire
निकलते	Stepping
विथ	With
मुकदर	Muqaddy
शरीफ	sheriff
मैरे	Mary
फत्ते	Fatte
एय	Ay,
नौकरी	service
माहेरबानी	Maherbani
फैसल	Faisal
मौकेपेचौक	Opportunity
आधिक्र	
शरत	autumn
भारतवासियो	People of India
ज़रूरी	necessary
कान्हा	Kanha
जेसन	Jason
पीरियड	period
अचाई	Okhai
खोले	Opened
सुर्खियाँ	Headlines
अकाउंट	Account
थीन	Thein
जगने	Waking up
महापुरुष	great man
सिटियुटेशन	Citation
अंकित	imprint
लिखुंगा	I will write
मोरोन	Moron
बडिया	Badia
बीता	A measure with one’s hand with the thumb and little finger stretched
समित	Samit
झुठ	Lie
भोस्दीवाले	Bhosdiwale
कोशिश	effort
युक्ति	argument
हने	
होजा	Hoja
बिरजू	Birju
हत	Hat
डाउन	down
क्यों	why
गड्डी	pack of cards
वालाय	
मुहह	Muhah
नसीब	fate
इमंदार	Honest
जावे	Go
अराए	Hey
पद्ज्ञा	Designation
हरने	Losing
राहने	Stay
बच्चो	Children
कक्षाओ	Classes
टोपा	covering for the head
मिल्के	Milke
इस्लाम	Islam
पिली	Pili
फॉल	Fall
टोडना	Break
रागे	Anger
भाद	Rent
अकबर	Akbar the great Mughal emperor
ज्टका	Jtka
करावोगे	Will do it
जरुर्त	Need
छोध	Leave it
लॉट	lot
ओचलो	Ochloon
वापसी	return
शर्ट	Shirt
चालने	Walk
भगोगे	Run away
हिल्ते	Moving
छोड़ो	Leave
फिरंग	Firang
गोल	round
अफवाह	rumour
सबका	Everyone's
मातोंडकर	Matondkar
ओह	oh! ha! good heavens!
उसे	her
कौन	who
बुराई	evil
बंजाथाय	Banjathaya
प्रियंका	Priyanka
माटर	Mater
इधर	hither
बनोज	Banoj
स्रहद	Sir,
यॉर्क	York
गब्बरसिंह	Gabbar Singh
यहे	Here
भूलता	Forgetting
फूल	flower
बिच	In the middle
चेरापूंजी	Cherrapunji
चिंदी	a small piece
राउंड	Rounds
जवान	young
चबर	Chabar
दूँध	Milk
बचपान	Childhood
पदी	In combinations series or group of lines of a stanza
केसी	Casey
होवेगीई	Will be
याकीन	Sure
रमज़ा	Ramadan
गाज़ाब	Amazing
मांगती	Asking for
दुस्ष्ट	Wicked
कुज	Kuj
ब्टाएगा	Will tell
मंगान	Mangan
फाव	Fav
कर्सकिंग	Karsking
बकलोल	Baklol
मज़ाक	joke
भट्ट	Bhatt
बदकर	with a bet
अंधियारी	Dark
रहे	Stay
ल्हायेगा	It will be
फेन	froth
लेहेन	Lehen
मोका	Moka
रेग	sand
खोला	Opened
र्टन	Raton
जैक्सन	Jackson
कुडाने	Kudne
मुंगेरीलाल	Mungerilal
एस्लेमाउलेकम	Eslemaulekam
लाइट	Light
आदे	Ade
रोने	Cry
रोये	Crying
सॉल्व	Solve
चाडा	Chada
आयशी	Aishi
तेजरामिन्सन	Tejraminsan
चोकरो	Chokaro
लगाकर	Planting
धूप	sunshine
तरपसे	Tarpase
बनाओ	Make
आइस्लैम	Ice Slam
बंधन	tie
आओगे	Will come
काधुला	Remove
माजबोरी	Majbori
हेहेह	Heheh
हैई	Hai
बोहोट	Bohot
हमसे	Us
फेसबुक	Facebook
ओईएईए	OEAEA
रस	juice
केल	Kel
हैब्बिट	Habit
रज़ा	wish
इदर	Idar
मैंगो	Mango
ग्रो	Grow
चाह	desire
मोर	peacock
ची	Chi
बेबी	Baby
बारिक	Fine
रहुलोनलीव	Rahlonleev
टाकी	Tank
एडस	AIDS
दुसमन	Dusman
अप्राधियो	Unsuccessful
डब	pouch
ओउर	Ur ur
राय	opinion
छाया	shade
भोग	Epicureanism
बेट	Bet
नफल	Failed
बरूजगर	Baruzgar
प्रभुजी	Lord,
लगना	To be attached as a label
हेलो	Hello
भावनाओ	Emotions
अभ	Now
कवि	poet
निबंध	essay
दस	the numerical figure ten
महिनेमे	In the month
थोका	Thok
रज़ान	Razan
सब	sub-
कोरी	Corey
मुबर्क	Happy birthday
धियान	Dhiyan
शा	Sha
चला	lightning
प्रियरंजन	Priyaranjan
करवाणे	To do
थोडेना	Not a little
कुम	Kum
किडा	Worm
घाट	wharf
फट्टू	Fattu
पटाके	Firecrackers
पासे	dice
हेर	Manipulated
नंबर	number
होएगी	Will be
खूब	Plenty
जिनका	That
सालमान	Salman
रुगियाई	Rugiai
पाकोडे	Pakode
प्यारा	dear
सिखाओ	Teach
बेन	Ben
उखाड़	Uproot
होगियाप्की	Hogiapki
जकदा	Jakda
झूठा	false
पोध	Plant
सिरो	Siro
सुबेह	Subeh
चाल्क	Chalk
रेपिओ	Rapio
जनम	birth
वआउउ	Wow
आवू	Aavon
स्भी	All
जीतने	Win
कायम	Permanent
लाया	Brought
तुरंत	immediately
कहासे	From where?
हवास	sense
लादत	Loading
भुका	Hungry
दीई	Dii
वसफोडा	Constipation
स्वाल	Swal
इन्सल्ला	Insalla
नफरत	disdain
वासियो	Residents
एकट	Alone
लयकब	Layout
दासो	Daso
बाज़ार	market
बेज़ती	Useless
होंगे	Will
रेल्लीय	Raille
मस्लमैन	Muslman
बोलेंगे	Will speak
गर्वी	Proud
ढूँडे	Find out
मस्टग	Mustag
उन्मे	Among them
सेवैन्या	Service
आस	hope
गी	Gie
बाटो	Share
यूजफुल	Useful
दुर्भाग्य	ill-luck
जता	
चलेंगे	Run
जैन	A sect who follow the teachings of Jain Tirthankara
देवर	husband’s younger brother
जोड़ना	to join
किसान्स	Farmers
मार्टे	Marte
बहत	Baht
जटा	Matted hair as of some sadhus
बतला	Told
माराय	Marai
हाइटब	Hitab
हाटा	Hat
देखिये	See
ताबी	Tabi
इलेक्शन	Election
उत	Products
पॉवर	Power
प्रद्युमन	Pradyuman
मुहतोद	Muhtod
पिटेगा	Beat
मुश्किल	difficult
पक्क	Sure
क्रिटी	Criti
प्राती	Copy
एक्च	Ch
वादा	promise
मू	Moo
दूबती	Doubati
न	The twentieth consonant of the losing anything Devanagari syllabary
अग्र	foremost
टाइम	time
नेगी	Negi
भटकने	Wandering
रजदीवा	Rajdiva
लार्की	Larky
हेल्प	Help
डू	Doo
उए	U a
छ्लना	Cheating
हल	solution
खोलो	open
ह्न	Hn
सिखेंगे	Will learn
ओप्टन	Opton
श्मझाया	Shmazhaya
डिटे	Dite
ग्राम	Gram
थोरी	Thori
कोये	Who is this?
आसू	Tears
लगने	Seemingly
ब्रोशा	Brosha
रखकर	Placing
विचारो	Think about it
चुट	Chute
एनफ	Enough
कोस	distance of three kilometre
आच्याचीई	Good
इम्वकोहली	Imvkohli
त्बी	Tbi
ऑल	All
जबरदस्त	tremendously
साचे	Mold
बेटिकोड	Beticode
वृन्दावन	Vrindavan
हमम	Hmm
पप्पू	Pappu
अय्येना	Ayna
वुल	Wool
आबादी	inhabited place
लेंगे	'll
सिंह	lion
उम्मीद	hope
बोये	Boy
कुट्टा	Dog
मसूमियत	Innocence
लेकेन	But
लेजाएगा	Will take
मिया	Mia
टीनो	Tino
कुदिये	Kudiya
रारुख	Rarukh
हरमज़दी	Harmajdi
हाउ	grindstone
घ्त्या	Nests
लॉग	log
अन्नाजी	Annaji
गाना	to sing
ऐप्का	App
सर्म	Sarm
ज	The eighth consonant of the Devanagari syllabary
परियान	Parian
जमाह	
समाजवादी	socialist
चिल	Chill
समप्ती	End
सतक	Satak
आरे	Ary
बेचारे	Poor
गाय	cow
पहुँचने	Access
कारियो	Do it.
मक्सद	Maxd
बूउहहत	Boouhat
बुबरखो	Bubarkho
किसे	to whom
गरबग	Garbug
खुलना	Open up
एकलाउता	Alone
धूम	smoke
खट्टे	Sour
वाकाई	Wakai
लोट	rolling
आईय	Mother
अमर	immortal
लेकी	But
डखते	Looking at
सड़कों	Streets
अख	Akh
पथर	Stone
विश्वश	The world
सोचना	to think
शेक	Shake
करवाओगे	Will you get it done?
बैथे	Sit down
उनहोनी	They are
कहने	Say
पैक	pack
मजा	pleasure
दखेगा	Will see
पागलो	I went crazy
इरादा	intention
काम्म	Work
वर्नग	Verng
करेंगे	Will
हूश	rustic
बेचता	Sells
केसाहे	How
चुन	Choose
रोज	Everyday
भान	change
आजे	Today
चेलांगे	Challenges
झाडियाँ	Bushes
क्लास	class
भुत	Ghost
गीत	song
किटनी	How much
ओच	Och
करेयेन	Will do it
कटले	Cut off
गौरी	a fair-complexioned woman
आची	Achchi
डर्र्र्र्र	Derr
प्रदीप	lamp
मेहँगी	Expensive
छोकरा	boy
मचा	Macha
फाटी	Cracked
फाड़	Tearing
मेली	associate
बानुगा	Banuga
सूरज	The sun
दांतना	Teeth
उचा	High
इन	these
जगोरी	Jagori
राखने	Keep
ब्रबर	Barbar
इंकी	Inki
गल्ट	Wrong
पक्के	Sure
दामोदर	Damodar
बनेगी	Will be made
अहहह	Ahhhh
देख	seeing
औसवस्नव	The Aust
कराटे	karate
सायंग	Sayang
दारो	Fear
इकठ्ठे	Together
लुत्ना	Looting
रजाई	quilt
जूऊ	Juu
तागडी	Strong
ख्वाब	dream
खासित	Special
बजरंगीभाई	Bajrangibhai
क्भी	Sometimes
उष्मे	Heat
पीछे	behind
भूप्पी	Bhupi
सिकाते	Sikate
बाकियों	The rest
वेस्ट	West
वोही	That's it
तोह	Toh
मूड	mood
जिसका	whose
दिजे	Give it
टुकडे	Pieces
बेटर	Better
शाजियालमी	Shajialmi
बिनाआ	Binaa
बनायेंगे	Will make
आजा	paternal grandfather
थो	
मस्स्त	Mast
मुजरिम	criminal
शुक्रिया	thanks
दिस	Dec
पेछेले	The past
खिलाओ	Feed
जितया	Won
साहिद	Shahid
सेना	to hatch egg
जुन्टा	Junta
रोंगी	Rogi
खिलती	Blooming
चिपकाया	Pasted
आईस	Ice
मूव	Move
अल्लाह	God =
अरय	Aray
येन	yen
सम्जे	Understand
सत्या	The truth
जाएगा	Will
सारिका	cuckoo
रखना	to keep
चूटिया	
प्रदेश	region
दुख	suffering
अजमेकर	Ajmer
पुक्का	Pucca
बुदपे	Budpe
परफल	Parphal
एंशान	Anshan
इस्का	Iska
भरवा	Fill in
बेथ	Beth
जयन्गे	Jaynge
प्रमाम	Pramaam
सिफ	Sif
दिल्लगी	practical joke
कृषि	agriculture
कादर	Kader
मुझय	Me
होर	Hor
भवनयेन	Buildings
भवानाओ	Bhavanao
क्बुबसिर्टी	Cbübsirty
वरदान	boon
दुनी	Duni
छती	Chest
आंकों	Numbers
मैक	Mac
रब्ब	Rabbi
विस्वास	Faith
वस	Vas
श्यद	Yad
ताकत	energy
अरामसेक्रिकेट	Aramsecricket
राज्य	kingdom
जेतेगा	Will win
जहील	Jahil
बल्ला	cricket bat
घूमा	roll
छोर	border
ओल	personal bail or security
मन्ते	Mante
चालरा	Chalra
आबाय	Aby
आकार	form
सालय	Salay
फान	wedge
नमो	NaMo
भूले	Forgotten
झुटटे	Lies
खेल्ता	Play
किस्को	Kisko
माचेग	Macheg
धीखा	Slow
रैना	Raina
क्सी	Xi
जुलाई	July
जम्मू	J
इटनातो	It's not
साउच	Sauch
नौबत	miserable condition
खोसी	Khosi
गिरगित	Chameleon
समील	Samil
चोटा	treacle
गर्व	pride
तप्तक	Heat
भोंसिदिके	Bhonddike
करेने	To do
सोजा	Sleep
फिजिकल	Physical
मूर्ति	idol
थे	were
बुलाती	Call
कुकर	cooker
बजरंगीभाईजन	Bajrangi Bhaijaan
तमचा	Your
फिसल	slip
तैसी	Taisi
बेबो	Bebo
कर्ना	Karna
बब	Bob
ढालने	Mold
रहुँगी	Will stay
उतेरेगी	Will you get it?
उसकाह	His
रकी	Rocky
पहेले	First
उगल	Spewing
तुजमे	You
पेट्रोल	Petrol
वाईजान	Wijan
कुत्ते	Dog
हल्ही	Recently
बॉन्ड	Bond
सर	Sir
चाटे	Chate
बोलहाटा	Speak
काइसे	How to
सब्जी	vegetable
मुस्कुरावोगे	You will smile
उन्हें	them
मुअम्युह	Muamyuh
रैली	rally
अक्षरहासन	Aksharhasan
घाटी	mountain pa
लागवा	Apply
बिगर	Bigger
सजेस्ट	Suggest
इलावा	Apart from
ला	Law
संजयसैनिंसा	Sanjaysainsa
आधी	Half
जीतनी	Winning
दिलो	Give it
खोलने	Open
कहकर	Saying
शोर	noise
ख्राब	Bad
मसिक	Masik
हैंग	Hang
बाश	Bash
प्रभुकिराइल	The Lord
ध्क्ता	Dhkta
बिकास	evolution
वैजान	Vaijan
तरफा	Sided
बहन	Sister
भारतीयों	Indians
कर्मचारी	functionary
बुलाते	Call
बनाने	Create
धयन	Dhayan
जिन्मेदारी	Responsibility
मुस्लिम	Muslim
निकालेगा	Remove
फासा	Fasa
अर	spoke of a wheel
चर्चित	discussed
विजय	conquest
साथा	Sath
चाची	paternal aunt
सौरवक्वैश	Sourav Java
गिराए	Dropped
अजीत	Ajit
ताइसे	Taise
प्यो	Pyo
पहेंटे	First
खुजली	itch
मरनेवाले	Those who die
म्ब	MB
चमचे	Spoons
जाने	as if
हराव	Defeat
दर्शता	Visibility
भेजना	to send
भादक	Bhadak
जानप्प	Janap
सकेंगी	Can be able
दिली	cordial
क्रा	Kra
फंडे	Funds
जयूरत	Jurat
बंगाली	Bengali
ज़ां	Za
आग	fire
खुरापत	Khurapat
ताश	playing card
हस्ती	elephant
अछा	Good
होजता	
खिला	blossomed
जेनिस	Janice
आइसा	AISA
नाप	measurement
थुउ	Thuu
वैसा	like that
अहंकार	egotism
तीसरी	Third
दुग्नी	Double
हिदायेत	In instructions
कर्लता	Curls
भैंस	female buffalo
लेली	Taken
अलकस	idleness
ईयर	Year
बटेन	Batten
हैईईईई	Hieee
मरज़ी	wish
बदाना	Badning
लडोगे	You will fight
थुकवा	Spit
वैसे	By the way
सोचो	Think
आपकिया	Yours
मोलनी	Molni
गुनाहो	Crime
चोरहो	Thieves
जार	paramour
हमदर्द	sympathiser
ओसी	OC
फाक	Fake
हामारी	Ours
मेक	Make
नाटक	drama
गिरा	tongue
आंडर	Ander
खेले	Played
स्मझने	Understand
मैगी	Maggi
दोबना	Dobana
पैदा	born
सामज्ति	Compromise
दा	da
मुझपे	On me
आयसी	IC
सात	seven
प्लीज	Please
टोकूह	Tokuh
नोथिग	Nothig
खास	separate
आरक्षण	reservation
हीरो	Hero
गल्ली	Street
मनु	proto-man
दास	slave
फोरवेरलोन	Forever
होग्या	It's done
उन्नति	rise
दिखाएगा	Show
नामो	Name
हेई	Hey
जकाते	Zakat
इस्क	Isk
पुण्य	holy
समझदर	Wise
उठा	height
मोहब्बतीन	Love
टहे	Tahe
शिपज	Shipsage
उतर	descend
चहठी	Chahati
सुधार	reform
बिलकुल	You bet
चिया	Chia
खातिर	sake
बनोव	Banov
मरने	Die
मसाला	spice
एहसास	feeling
घरा	Home
कार्य	work
लेस्सों	Lesson
खछर	Mule
सुनंजी	Sunanji
दूरदर्सन	Television
येप	Yep
स्टिक	Stick
किरण	beam of light
सफल	successful
नामन्या	Namanya
बब्जुद	Babjud
भुला	Last
लुंगा	Lunga
फेयर	fair
अरहे	Hey
उमर	age
भुलियेगा	Forget
हुस्न	beauty
अच्छा	Good
पसंदीदा	favourite
आँगा	Anga
गैरत	Wrong
बरबाद	devastated
अयाय्यो	Ayyo
अटका	entangled
ट्यूशन	tuition
डायलोज	Dialogues
सुहागा	borax
मंडावा	Mandawa
मोनी	point
भूल	forgetfulness
डालो	Pour
री	Informal vocative particle used in addressing a female
एक्दुम	Ekdum
फार्क	FARC
पाटाखे	Crackers
स्टार्टन	Starton
देगा	Will
इन्तेज़ार	Waiting
पाप	sin
साहिब	sir
बद्दुआ	Baddua
हवाई	a kind of firecracker
मौहला	Mauhala
सीडी	CD
पठानो	Pathans
प्धाई	Study
बौहात	Shower
रेहा	Reha
चकरी	stone mill
दिलदारा	Dildara
बटाउन	Btown
गायें	Cows
वाई	Y
कायों	Why
मन्ता	Manta
सल्लू	Sallu
दोखा	Dokha
अं	Err
बालिकय	Girl child
सैटरडे	Saturday
पाकिस्तनियो	Pakistanis
रेफर	Referee
हेन	Hen
जानन्नन	Jannan
आजैगा	Will come today
मोडो	Modo
बहाने	Shed
जाना	to go
राई	A kind of mustard seed
फाकरे	Fakre
जोक	Joke
आब	water
चोकरियो	Chokrio
दावत	invitation
पी	The cry of a cuckoo reminding lovers of each other
हलाल	legal
नखरे	Tantrums
रखने	Keep
उन्हाय	He
पुरुष	man
इफमर	Ifmar
कोमेंट्स	Comments
सुमित	Sumit
बिहार	Bihar
पीचा	P's
बिगबच्चन	Big Bachchan
डूंगचालो	Dungchalo
शुरु	Start
लिखनाथा	To write
इस्मे	In this
रामदाव	Ramdav
बुटोन	Buton
सितार	to play sitar
चाहे	whether
व्हेरेसराहुल	Rahul
वझ	
उनकू	Unku
करवाओ	Get it done
लगाते	Put it on
तेनु	Tenu
खुदको	To myself
वकील	pleader
वसोल	
कुंजियों	Keys
योग्या	Correct
बायन	Invitation to attend a particular ceremony
एकमात्रा	The only
हुमारा	Humara
गई	Went past tense feminine singular of
टोडड्ड	Todd
नाव	boat
डख	Dakh
हाथो	Hands
माकी	Maki
चोर्क	Thief
चुटिएप	Chutiapp
सदा	always
बेचैनी	restlessness
पड़ते	Falling out
वि	Used with words derived from verbs to express opposition
पदया	Posts
वसे	By the way
अब	now
बेलगाम	unbridled
इंसानियत	humanity
जुल	double dealings
सत्यमेव्जायते	Satyamevjayate
नोटिस	notice
तुलना	to be weighed
नर्डी	Nerdy
खुसी	Happy
इत्ते	It's
लगाडेया	Put it
मिलने	Meet
सीखके	Learning
मेई	Mei
सच्चाई	Truth
अबितना	Abitna
तबाह	ruined
मिंटो	Minutes
बुडा	Buda
हिस्टरी	History
भागाव	Run away
हवाले	Pocketed
बधा	Increase
हेम	gold
विकाश	appearance
लार्कियो	Larkio
जिस्म	body
धेखे	Look at it
सुधरेगा	Will improve
सरत	Sarat
पीर्ती	Pirti
हरया	Lost
बेदी	Bedi
भाग	luck
नाहटा	Nahata
छ्ग	
बांकी	Banki
चेनिंग	Chenning
छोड़ना	to forsake
डेंगेय	
बांबानी	Bambani
महँगा	dear
चुप	silent
होंज	Honz
ठे	
ज़रिया	means
गणपति	god Ganesh
मारती	Kill
ज़ाकास	Zakas
डर्स्टन	Durston
स्टोरी	Story
मुडडे	Mud
सर्क	Sark
एमन्दर	Amandar
इस्को	Isco
सकता	Can
एइडी	AEDs
मुंबई	Mumbai
कैसन	Casson
येस	Yes
घुमता	Rotating
कलग	Kalg
मुद्दा	issue
उहह्ह	Uhh
मनिये	Believe it
पियरे	Pierre
पारे	Pare
वर्णा	Character
घंटो	Hour
डुबा	Drown
स्म	SM
थरकी	Tremor
उर्फ	Aka
न्हिई	Not
किधर	where
क	The first consonant of the Devanagari syllabary
जुथ	Juth
हीहे	Hey
बाज्ज्ये	Bajaye
सुनेगा	Will listen
मार्च	March
होंग	Hong
बारे	finally
मेमने	Lamb
बेहजोन	Behjon
यारर	Dude,
क्याकर्ता	What to do
जगक	The world
सन्यम	Patience
बैटिंग	Batting
जीतेगी	Win
अकत	Akat
कंगल	Kangal
जिंदा	alive
उस्का	Uska
वैट	VAT
जीने	Live
प्ड	Pd
वाद	suit
जनस्भा	Public
अखेर	Finally
बीना	Bina
डखने	Look at it
भो	Bho
पीति	Drinking
शिवरात्रि	Festival observed in the month of Phalgun for worship of Lord Shiva
साआला	Saala
बिज	grain
सारू	Saroo
तात्या	Tatya
छलें	Rings
जिसने	Who
ताऊ	uncle
अप्जा	Apja
बताएगा	Tell
स	The thirty-second consonant of the Devanagari syllabary
खेलते	Play
इमेजिनेशन	Imagination
सोचदे	Think about it
हंस	swan
रोकते	Deter
झाट	Jhat
एमिल	Emil
ग	The third consonant of the Devanagari syllabary
करदिया	Done
है	have
यूर	Eur
जिन्दाबाद	Long live
टोनी	Tony
प्राची	the East
चापप्प	
कार्डिया	Cardia
करके	By
फेंकू	Throw it away
रास्ता	path
टेल	tail
लीडर	leader
विनाशकारी	destroying
डेक्टा	Decta
जे	j
लाप्ता	Missing
अविषा	Avisha
मुबारक	auspiciou
जीतू	Win
खिराद	Khirad
ज्कडी	J.K.
ह्ग्या	
अपकैसा	How are you?
आईयू	IU
बाल्के	Balke
उठी	Arose
अजकिरत	Ajkirat
वर्क	Work
रूम	room
खेलेगा	Will play
डीड	Deed
पाचक	digestive
बंकर	bunker
व्पडब्डस्कनव	Vpadbdskanv
लाखों	hundreds of thousand
स्टिल	Still
बाबूजी	A word of address for father
आती	Come
पोरी	Pori
ब्यूटीफुल	Beautiful
तास	brocade
दाली	Cast
समज्सेव	Understand
चोदेगा	Will fuck
बढ़ी	Grew
सुधार्ति	Improvement
चैतन्य	conscious
राम	omnipresent God
थोड	A little
देश	country
बिथौगे	You will sit
आईसी	Ic
छुपते	Hiding
अरब	one thousand million
ब्बीन्दी	Bbindi
बेहतर	better
संदल	sandal wood
झुक	bend
लिखेगा	Will write
हिलने	Shaking
बवाहा	Bawaha
खब्बीस	Twenty-four
भौत	Wow
ड्रिंक	Drink
कहेंगे	Say
वाली	keeper
बनेगा	Will be made
माज़दा	Mazda
फन्नी	wedge
आशु	quick
मुम्मी	Mummy
हसन	Hasan
अलाहा	Alaha
समल	Samal
लौन्दो	Laundo
बसंती	yellow as spring flower
बन्दरिया	Bandaria
भाषण	speech
पाओगे	Find
पटल	thatch
जल	water
मिलती	Get
दाबा	Press
डांस	Dance
विट्टू	Vittu
आओजे	Come on.
गांडल्फ	Gandalf
सम्भाल्ने	Take care
स्पार्टन	Spartan
पूचू	Ask
म्र्स	MRS
लेन	taking
मनमोहन	captivating
कंट्री	Country
ऊऊ	Oh yeah.
ईईईएई	EEEAE
हुहु	Huhu
कर्री	Carri
हुमारी	Humari
पाटा	plank
डकबोस	
चाता	Chata
लिखते	Write
लुंड	torso
छत्तिष्गदिया	Chhattisgarh
जींद	Jind
विशालदद्लानी	Vishal Dadlani
क्रवा	Karva
खोलकर	openly
पति	Husband
मुझपर	On me
आजकल	nowadays
पूजा	worship
अंजान	Unknown
कलाम	word
फाइन	fine
हिसाब	reckoning
बाथरूम	bathroom
पाई	pie
अज्ज	Today
आगे	before
वोल	Vol
जानभूज	Life
रोटा	Rota
आपकी	Your
जानवर	living being
बेइजटी	Indignity
कुंजुइयान	Kunjuian
आँखे	Eyes
दालेंगे	Will put
तोरोगी	You will
उंगली	finger
अजना	Ajna
रतन	ratan
बच्पन्न	Child
चुनाबी	Chunabi
लूलवुउत	Lulvut
कलगे	Kalge
जयगे	Jayge
महात्मा	A holy or pious man
हहहा	Hahaha
तिआर	Tir
कर्रे	Karre
ठंडे	Cold
अल्वेस	Alves
स्पेशल	special
चीर	cloth
सुरेश	Lord Indra
उछल	fly
कासे	How
इस्मीन	Ismin
ऑड	Odd
दिष्ता	Dishta
टैब	tab
मैं	I
ट्यूस्डे	Tuesday
बोहो	Boho
गोली	marble for playing
मुबारख	Mubarak
गोलिया	Tablets
ह्गये	
स्टिकर	Stickers
ड	The thirteenth consonant of the Devanagari syllabary
लिखय	Write
मरा	dead
एगर	Agar
सूचिडे	List
मनायेंगे	Will celebrate
बॉम्ब	Bomb
मनमनी	Arbitrary
स्वीटर	Sweeter
किकाड	Kikad
जंग	a large
कापडे	Clothes
नानी	maternal grandmother
तरह	kind
परदेश	foreign country
भरुंगा	I will fill
सिखा	teach
फ्लॉप	Didn't
किडडे	Kids
घूर	stare
सरकारो	Governments
चोदेगी	Will leave
देकेता	Look at it
उमरिया	Umaria
मस्तत्त	Mast
विडियो	Video
मित्तल	Mittal
शो	show
हमाई	We
डोबरा	Dobra
डोगे	Doge
सेक्सी	sexy
नवरात्रि	Navratri
जाल	net
मानेगी	Will agree
इंत्जार	Waiting
तम्माम	Tammam
द्रोही	malicious
स्टार	star
हरयाणा	Haryana
खले	
जागीहुई	Woken up
गद्दारी	Treachery
कोटि	grade
चहाय	Tea
दूर	distant
अजाती	Non-caste
डैम	Dam
कण्ड	Kanda
देति	Give
मेहरबान	kind
आँगन	courtyard
भैजिने	Send it
इतेनी	It's
रोलाओगे	You will cry
मांगी	Sought
कश्मीर	Kashmir
अहसास	feeling
दाल	pulse
हुयी	Happened
बेर	jujube tree fruit
दरजा	rank
मेंटल	Mental
सचे	The truth
ओईएईएई	OEAEAE
भाशंबाज	Speakers
बाम	balm
जिस	oblique form of  who
रखते	Keep it
क्नजर	Kanger
ह्मारे	Ours
धुप	Sunshine
विकासजादो	Development
तारों	Wires
डायन	witch
रूला	Crying
आह	Ah ! alas! an expression of pain
दुन्या	The world
उठाने	Take
इलू	Ilu
बिस्किट	Biscuit
भक्त	divided
लाटे	Latte
जाली	network
रूक	Stop
लेटे	Layte
यहाँ	here
बंदरो	Ports
रहाने	Rahane
हमारे	Our
फेबरुआ	Fabrua
दिमग	Mind
बताये	Tell
लिस्टन	Liston
रशन	Ration
छत्री	umbrella
राहे	Stay
रहाये	Stay
पोरा	block of wood
उल्लू	owl
धाकन	Dhakan
पिल्ला	puppy
प्र	indicating before
साल	Sal tree a timber tree
ग्रंडपा	Grandpa
भाक	Bread
रागा	Anger
पाकडी	Cook
ता	Ta
खस्ता	crisp
गांद	Ass
वाजपेयी	Vajpayee
अबतक	So far
बर्थडे	birthday
भोहोट	Bhohot
बदला	retaliation
स्वेटर्स	Sweaters
रौ	flow
रेहेम	Rehem
सोचते	Think
बोलू	Speak up
मरेगा	Will die
कवली	Kavali
ताब	heat
आलग	Different
अरविन्दरगुजराल	Arvind Gujral
उसा	Use it
टॉर	Tor
भीव	Bhiv
गौमुत्रा	Cow urine
जुगड़	Jugaad
नराज	Angry
इंतजार	wait
भला	good
बहिया	Bahia
संजय	Sanjay
यरो	Yarrow
बिस्वास	Biswas
पदता	Position
डैमन	Damon
बंचुका	Banchuka
गुण	quality
अक्षरा	Akshara
लमाओस्डफजकलम्ग	Lamaosdfjklug
उत्तरदैतव	Answer:
बेय	Bye
लाडली	Loved
दीबान	Diban
ओफर	Offers
जोर	effect
फैदा	Benefit
संभालेगा	Will handle
मजे	Interesting
डवर	Davar
गरीबाउन	Poor
रुलायेगा	Will cry
बिगड़ता	Worsening
अस	Us
बलम	lover
उर्मिला	Urmila
गयी	On
मुफतखोरों	Freebies
जब	when
प्धो	Read
उस्क	Usk
शिवरूर	Shivrur
वू	Wu
राहती	Living
आआआआ	Come on.
ब्तायाकी	Tell me
दुगे	Duge
हिम्मत	spirit
चाम	skin
फुचेगी	Fuchegi
राखी	A colourful thread to be tied on the wrist of a brother by his sister
रुमाल	handkerchief
मार्केट	market
कहेगा	Asking
थेले	Bags
सलाम	salutation
उठे	Get up
देखत	Look at
वापिस	Back
खेलके	Games
बनून्गा	Will be
बल्की	But
बनाता	Builds
मुन	Mun
घाने	Ghana
बजरंगी	Bajrangi
जैसे	as
कृते	on behalf of
यी	Yi
हरी	green
लुक	glaze
घरवालो	Family members
भोट	Bhot
अलास	Alas
वरी	worry
दष्त्वीत्स	Visions
गेम	game
जीना	to live
मोनित्र	Monitor
वाडकी	Wadki
भेंचोड	Bhenchod
सेक	SEC
फोड़	Bursting
नमस्टा	Hello
एडम	Adam
हिजो	Hijo
कॉक	
जेसा	Like
बैच	Batch
बीस	the figure of twenty
लड़ाई	fight
चॉकलेटी	Chocolate
रेहाय	Rehai
अरमान	longing
क्री	Cree
मांगते	Asking for
सुनायेगा	Will tell
अकली	Alone
खोल	cavity
तुमने	You
पान्ते	Pante
पधेंगी	Will read
अवनिश्काजला	Avnishkajala
इमांदार	Honest
मुबार्का	Mubaraka
दलालो	Brokers
बानरेहा	Banreha
देखकर	Seeing
तुउ	You are
सोच	thought
लेने	Take
बंदियो	Captives
फिक्स	Fix
सुनी	Heard
विरजी	Virji
फज़लू	Fazlu
च्श्मा	Glasses
सेटिंग	Setting
आर्थी	semantic
आयोगे	Commission
हामले	We
दमल	Damal
कोही	mountainous
चुटियाप	Chutiyap
दाँत	tooth
खानहुम	Khanhum
सहर	Sahar
मझ	Me
फिदातो	Fidato
आ	The second vowel of the Devanagari syllabary
हॉ	Yes
लल	Lala
तुई	Tui
न्क्साइट्फनिस	Nxitfunis
ताभे	
एस्कुचर	Eskuchar
बो	sow
मोम्मी	Mommy
काफर	Kaffar
पुचना	Ask
लवंडियाबाजी	Lavandiyabaazi
शाही	royal
वॉलेटेकर	Voltaker
गोइन	Goin
थोरा	Thora
इंसाल्लाह	Inshallah
पम	Pam
प्ल	Plate
एसिलिये	That's why
लोकपाल	Protector and feeder of the world
रबिया	Rabia
घुमा	Twisting
हेहेहेहे	Hehehe
पहके	Pahke
मार्के	Markey
इम्हो	Imho
ग्वाला	cowherd
जिम्मेदार	responsible
कटी	Chopped
मोरारजी	Morarji
जैब	Jab
ह्म	Hmm
अपसा	Apsa
खैर्नाह	Khairnah
नुंबे	Numbe
काराय	Do it
उठ	Up
केसे	How
सैबलॉगन	Sublogan
शुक्ला	Shukla
धन्यावाद	Thank you
वुम	Wum
लगरे	Lag
अपने	Your
लालू	Lalu
बढ़ने	Grow
डिगे	Dige
घोंट	Suffocation
बेचे	Sold
इंटरवेल	Interval
भिखारी	beggar
मोदीशाही	Modishahi
नशीला	intoxicating
लेइन	Lein
कैलान	Callan
उम्माइड	Hope
पहला	first
बिगड़	Worsening
बिटवा	Bitwa
सुनो	Hey listen
र्हाना	Rehna
गुजारी	Passed away
कैरी	small unripe green mango
पहुँच	arrival
नरेंदर	Narinder
ईस	This is
आभे	Now
मून	Moon
झेला	Catch
लगी	conflict
प्रसून	flower
कोरो	Koro
एलाकाइमाइन	Alakamine
सहीद	Sahid
र्त	
उस्से	From him
सकदा	Sakda
महीने	Month
कराय	Do it
वुगदा	Wudda
मेरे	my
जनेगा	Will know
कहाँ	where
पाइक	Pike
पूरी	A thin bread or cake fried in ghee
उल्टी	vomiting
लागरा	Lagra
बेबकुफ	Stupid
परर	Parr
अकी	Aki
दमदमा	Report of a booming gun
डेंगेई	Dangei
राहेते	Stay
मुक्त	freed
उद्बिलाओ	Excited
अक्टूली	Octoly
मकर्शक्रांति	Makarshkranti
कैन	can
द्रगरेकर	Dragrekar
चिटिया	Chitia
पायुगी	
बागवान	Gardener
उर्ल	URL
मोदिजे	Modije
मलिक	king
बर्क	Burke
रलियाँ	Rails
हटकर	Away
देने	Give
तशन	Tashan
सुधार्ते	Improving
लायक	worth
आज़ादीई	Freedom
रत्रपिता	Father of the night
अब्बा	father usually among Muslim
गर्लफ्रेंड	Girlfriends
टॉड	Tod
किदर	Kidar
जैसस	Jasus
हूर	a virgin of paradise
रिरी	Riri
छ्डंज	Chhandj
पुजारी	priest
मार्ग	way
बत	word
डोगरा	A caste of warriors belonging to Kangra and Jammu regions
चाह्टी	Want
होसियारी	Hosiari
अवे	Away
महनगाई	Inflation
निगम	corporation
गुरुगे	Guruge
ब्टेट	Buttet
खेलेंगे	Play
केना	Kenna
गरीब	poor
अन्होनी	Anhoni
पकडा	Caught
दिमाग	brain
मसग	Masag
पुचो	Ask
मिलिया	Milia
डी	D
ज़बरदस्त	strong
वृंग	Vring
कृपाय	Please
बच्चों	children
डिगा	Diga
संझने	Saanjhne
डॉबट	Dobutt
हरता	Losing
बीइंग	Being
बीकानेर	Bikaner
विशेष	special
धाड़	uproar
पूछ	enquiry
भूषन	Bhushan
चिपक्ती	Sticking
लड़को	Boys
थेक	Thek
झोखा	Jhoka
कही	Where
हेलोग	Hey people
इंतजर	Waiting
श्बे	Shbe
रेनकोट	raincoat
समज़दार	Wise
ओक	Cup formed by joining both hands
सोबको	Sobko
नादा	Nada
पहुच्ते	Arriving
बुआ	aunt
लेगी	Will
दोगी	Will give
टेंशन	Tension
डीखाटीया	Seekhatiya
नमस्करं	Hello
भगने	Run away
लेंनगे	Lange
जादुगर	The magician
बचत	saving
समता	parity
सप्ररर	Saprar
लोंडे	Londe
किस्किडिल्ली	Kiskidilli
एई	Ae
अग्ली	Ugly
कांग्रेस	Congress
जाकार	Go
परत्य	Return
वरत	Above
माइकल	Michael
डवा	Large wooden spoon or ladle
रामदान	Ramadan
कहुँगी	I will say
कौल्ड	Cold
मुल्क	country
जगेह	Wake up
अजाद	Azad
वलेके	Valeke
पल्लूपोवर	Pallupovar
बोल्डे	Bolde
गुउडू	Guudu
तेगा	Tega
समजेंगे	Will understand
टकट	Cut
पड़े	Lying down
फैज़ल	Faisal
हुमारे	Ours
उद्बुलाओ	Bulb
भाईसाहब	Brother,
कार्टी	Carty
हर्कतों	Movements
दुसारी	The other
तन	body
हटाओ	Delete
बुर्रराहा	Burrah
मुसलमानो	Muslims
जजबती	Passion
सोंग	Song
ठंड	cold
जितेंगे	Will win
रहेहो	Are you
नुश्किल	Nushkil
रख्ता	Keep it
किती	How much
डाक	post
पुरानी	chronic
पाकिश्तान	Pakistan
येलुगुरी	Yelluguri
होता	One who offers oblations in a sacrificial fire
कार्लो	Carlo
थेन	Then
छोटू	Shorty
करवाई	Action
लोगप्रियता	Popularity
टैग	tag
डोइंग	Dowing
स्मझकर	Understand
अम्ज़िंग	Amzing
ट्रैफ्स	Truffs
बगैर	Without
खौब	Khaub
तूर	a weaver’s brush
साथ	with
निजामुद्दीन	Nizamuddin
प्रभु	God
पजामे	Pajamas
बनी	Made
हना	Hannah
थक्नाह	Thaknah
निर्माण	building
सायकल	Cycle
मानते	Believe
रोटे	Rotis
पब्लिसिटी	Publicity
जजबे	Judges
लिखे	Written
क्युकी	Because
बजपसामवाद	Rhetoric
चाह्तिहा	I want
उत्सुक	keen
देकिये	Look at
आमद्मिपर्ति	Income
पेसो	peso
जैहू	Jaihu
मात्कस	Matkas
आइंडा	Ainda
भ्र	Bhr
फ्घ्त	Fght
बापू	father
पांजा	Panja
दियो	Deo
घमंडी	proud
मुआ	dead
छपपार	Roofing
डड	Dud
बनौन्गी	I will make
बनादिया	Made
पाने	Get
हिना	myrtle
तुजको	You
मायी	magical
उहूउ	Oooooo
ययाययाय	Yayayyay
बुन	knit
भैय्यो	Brothers
मंत्री	minister
मोरेना	Morena
तरस	pity
वड	Vada
चाकर	servant
नवेम्बर	November
पिस्ट	Pist
जीतेगइंडिया	WingIndia
लुग	Luge
कोसिस	Cosis
मेहँदा	Mehnda
ही	only
चुड़ाई	Chudai
जीतो	Win
हे	O
उतारने	Unloading
श्मता	Shmita
ज़गाह	
दलदे	Dalde
देव	God
मीन	fish
शलुऊ	Shaluu
मिटने	Erase
कहली	Said
एसा	Such
लनत	Shame on
मोंडे	Monde
चोडिये	Chodiya
दिख्थ	Looks like
निकाहटू	Nikahtu
बैब्बर	Babbar
हई	it is there
ठनक	Jingling sound of a silver coin
नगमा	Nagma
उसको	to that
बान	keeper
दवाई	medicine
मेसेज	message
हिप	hip
पॉसी	Posey
सुबुक	light
होटे	
दालना	Putting in
गौरनविट	Gauranvit
काल	time
लगते	Takes
भेजा	brain
थकी	Tired
आसाराम	Asaram
संध्या	evening
भांडारकर	Bhandarkar
देगी	Will
जयगा	Will go
टीयर	Tier
दडबे	Press
मामू	Mamu
स्लमैन	Slumman
भाईईई	Brother
छुआका	Touched
हती	Hati
ममता	affection
पडोसियो	Neighbors
करदे	Do it
करोड़पति	millionaire
मुश्किले	Difficulties
किसानो	Farmers
सूरज़	Suraj
चिन्ता	concern
वालेय	Those who
शब्द	word
आइप	Ip
हूरे	Hoore
मिशेल	Michelle
इंटेहा	Inteha
रुंस	Runs
अनीता	Anita
सचिनिंसन	Sachin Tendulkar
घुसर	Ghummer
जिंदाबाद	Long live
जयजस्थेदिवा	Jayjasthediva
खिलाये	Feed
रुकेंगे	Will stop
भोकली	Bhokli
सुन्न्ते	Sunny
सुजेस्शन	Sujesson
खिंचवाने	To be taken
गुलमोहर	Gulmohar
खिलाफ	reversal
प्रेशन	Pressure
आयगा	Will come
नज़र	sight
डब्बा	box
दिखाने	Show
फसी	Trapped
छा	
डॉपलीज	Doppelles
बोलते	Speak
आडवट	Hurdles
बचपन	childhood
सुचित्रा	Suchitra
जभ	When
चुगलखोर	telltale
अपास	Apas
लिखबडू	Write
अलेकुम	Alekum
सीधा	straight
छाके	Shadows
मुस्काती	Smile
सच्ची	true
भगोरे	Runaway
बजर्नाग	Bajarnag
एंटेना	Antennas
कर	hand
बाजरंगी	Bajrangi
जहानुम	Jahannum
धोनी	Dhoni
बन्नी	bride
अबी	Abi
उधीक	Too much
उसपे	On that
देखती	See
असदुद्दीन	Asaduddin
मांगना	demand
परदा	screen
ऐवी	Avi
फंडा	Funda
गर्ल्स	Girls
पाधकर	Padhkar
हरना	to kidnap
साहब	sir
टेरिया	Teria
हार्दिक	hearty
बादलो	Clouds
आगर	Agar
बद	bad
त्म्हरी	Your son
लिखेंगे	Type
भगो	Run away
दोस्तो	Friends
बैठटे	Sit down
सम्भली	Possible
आपकिसरकर	Your government
ते	To
गौ	cow
सोहने	Sohne
सिदी	Sidi
मच	Mach
हमलोक	We are
बनाई	Created
हिलना	to move
मोहित	fascinated
रोकने	Prevent
बेह	Beh
टिक	stop
आराहा	Araha
कन्हैया	Kanhaiya
लॉगन	Logon
ब्टेजी	Bteji
आइसे	Aise
धब्बा	stain
वोटो	Voto
पान्ती	Panti
बुखे	Hungry
बताते	Show
फ्रैंडशिप	Friendship
गरू	heavy
बच्चा	child
बिगड़ा	impaired
जाओगे	'll
सुपव	Supav
हूँ	am
सोब	Sob
अश्वमेधा	Ashwamedha
सेरिफ	Serif
कोलगेट	Colgate
भूत	ghost
साश	Sash
उपासक	worshipper
वेलकम	Welcome
सुल्तान	sultan
हॉकर	hawker
जोआ	Joa
भगवान	god
बहत्त	Very good
तुजे	You
बालतकारी	Bullying
अजोआ	Azoa
गरमीन	Summer
आएग्ये	Have come
एप्मुस्लिम	Epmuslim
नाज़	Naz
पधुंगा	I will read
गुजरते	Passing
फेंके	Others
स्बक	Sbuck
बोस	Bose
देखओंगा	I will see.
दबाना	to be compressed
लगाओ	Put
चलतेय	Going on
दुगा	Duga
क्रताय	
मिलेनही	Not found
मिर्ची	Chilli
डर्ड	Scared
लाए	Brought
प्दी	P.D.
भूउउत	Bhuut
करेगी	Will
दानिरुधा	Danirudha
फेविकॉल	Fevicol
ऑय	Ayy
लूज़	Loose
देखना	To see
डोंगिरी	Dongiri
पत्ती	small leaf
गोहर	a pathway for cattle
कुसल	Kusal
अक्षर	letter of alphabet
शॉप	shop
कैलाश	Kailash
हरमज़डे	Harmazade
बेस्ट	Best
मिल्टी	Milty
राहत	repose
होगेये	Will it happen?
महाशिवरात्रि	Mahashivratri
बिभुतियो	Bibhutio
फटखे	Bursts
शराबी	intoxicated
व्हाट	What
बुलाओ	Call
चरने	Graze
फोडेंगे	Will break
अभुतपुर्वा	Unprecedented
ज्यादा	more
कोनामी	Konami
पेपर	paper
लैग	Lag
आतंक	terror
इंटरविय	Interview
अब्ब	Abb
बाग	rein
करवा	A pot with a spout
भजरंग	Bhajarang
चिरकुट	bit
धरम	Dharam
पालते	Pet
लिंक	link
लड़कों	Boys
गिफ्ट	Gift
लड़कोयो	Boys
नाल	horseshoe
लाद	tummy
गालिब	Ghalib
आसान	easy
सारा	all
कोच	coach
पाओ	Pao
लेय	Take it
उस्कू	Usku
बकाज़	Bakaz
पंखे	Fan
रेहे	Hey
रामज़डे	Ramzade
मंदिरा	Temple
डोसे	Dose
ह्यूह	Huh
लगा	hook
ऊन	wool
खतरे	Danger
जलवा	Fire
सन्नाटा	silence
थापा	Mark or impression of the palm of a hand
किनी	Kini
चिलने	Scream
बेनामोस	Anonymous
तारी	savior
ब्टाउ	Tell me
इतानी	Itani
राही	traveller
घें	
हस्ते	by hand of
आपनिया	Your
मागी	Magi
आयये	Come on
शास्ता	governor
कॉपी	copy
वुड	wood
हनी	Honey
इत्व	It's
क्रोगे	Kroge
आइयाने	Aiane
कलंक	spot
फुस	soft sound
माचा	Macha
ईस्बार	This time
कमेंट्स	Comments
रवप	Ravp
कल	yesterday
कुंजजीया	Kunjjiya
बिदेसून	Bidesun
झुट	Jhoot
बादल	cloud
काइकु	Kaiku
फेमस	Famous
मा	ma
डुह	Duh
बेना	a fan
हुक	hook
फिरना	to turn
जुखम	Cold
मेह	cloud
मुहब्बत	love
सत्यनाश	Destruction of truth
दुकन्दर	Dukandar
सामने	in front
क्रे	Cray
गेट्स	gates
सायद	Sayed
तलवार	sword
लड़कियाँ	Girls
सब्र	patience
शमत	Shamat
फक्कू	Fakku
अलीकुम	Alikum
हरमके	Haramke
घुमे	Turn around
बुसी	Bussy
पहुँचुंग	Arrive
बचायेंगे	Will save
सालुउउउउ	Salouu
कुर्ता	loose collarless shirt
देराहा	Derah
टोबाकार्ले	Tobacarle
बधाया	Congratulations
देते	Give
सोम्यूज़र	Somuser
फ्लाइट	Flight
देशभाग्तो	Patriots
संस्कृति	culture
दिलेंगे	Will give
साव	Saw
कुछच	Something
जट्टे	Jatte
बेहेंचो	Behencho
सेलेक्ट	Select
मजीद	Majeed
कभी	ever
हुड्डा	Hooda
बौचर	Shower
रोजगार	employment
समना	Samana
तिया	woman
टैटम	Tatum
दिव्या	nymph
टमलोगो	You people
लडवते	Fighting
परबलम	Problem
लाजवाब	unable to reply back
लायो	Bring it
सीटाइन	Cittain
सुधर	Improve
किजेयेगा	Will do it
मिआ	Mia
छे	Good
सिरजी	Sirji
च्लायेगा	Will work
सलामी	salutation
किसका	whose
इंशाल्लाह	Inshallah
गार्बी	Garby
रिया	Ria
धरणा	Dam
मेहेना	Mehena
काहते	Where is it
दी	Given
बजरंगबली	an epithet of Hanuman
भौकली	Bhaukali
फ्लव	Flav
लल्लू	Lallu
दयाराम	Dayaram
पुराने	Old
बने	Made
क्रोगगे	Angry
स्मझे	I understand
बनायेगा	Will make
इंतिजार	Waiting
हम्हे	To us
सेंस	Sense
मात	defeat
थ्राह	Thrah
एर	Er
क्रेगी	Craigie
ब्यी	Bye
कौवा	crow
वार्ना	Warna
जेठा	eldest
ब्दिया	Badia
प्लान	plan
तुझी	Yours
झंद	Flag
ल	The twenty-eighth consonant of the Devanagari syllabary
लोकप्रिया	Popular
अबा	loose cloak or apron
कोंगरेस	Congress
द्वारका	having many gates
लॉक	Lock
पूज्ज्य	Revered
खुदा	Inscribed
रिलीज	release
हल्ला	noise
पनवेल	Panvel
कॉलेज	College
दिजिये	Give it
चोरने	Thief
धारणा	presumption
इवरा	Evra
लौटा	dissuade
मो	Mo
राजीव	lotus flower
एपनिया	Apnea
करोंगे	Will do it
डेन	Dane
भिगने	Soaking
निकाल	eject
गुनाह	sin
कारवानी	Carwani
जिल्ले	District
कास	cough
भांड	pot
डकल	Duckle
पापजी	Papaji
इंग	Ing
ज़मा	Zama
चुटियो	Chutio
सोचती	Think
क्रनय	
पिक्चर	Picture
धासुउ	Dhasu
बदलाओ	Change
ब्रा	bra
पटाखे	firework
दूसरा	second
चर्चा	discussion
उत्ने	Utne
ऊओ	Oh,
ब्मार	Bmar
बातों	Things
जॉनी	Johnny
गन्ते	Gante
रहबारी	Rahbari
हारो	Lose
बॉलिंग	Bowling
अज़ादी	Freedom
अहाहा	Ahaha
कारवती	Karmavati
डिजो	Dijo
धनुष्क्रजा	Bow
सम्मान	honour
एटना	Etna
लिजो	Lijo
चोक	choke
अहा	aha ! excellent
भज	Bhajan
दुश्मन	enemy
हान्ने	Hanne
फाल्थी	Falthi
लो	just see
बिमारी	Illness
सवन्ना	Savanna
भेन्चो	Bhencho
पड़नेवाला	Falling
पुचा	Ask
रख्ना	Keep it
लदको	Ladko
सिकहया	Taught
सुरीली	Surili
मोना	clean-shaven person
भाकी	Brother
दीवाना	mad
छु	Hide
विस्तार	expansion
परफॉर्म	Performance
रीसीप्ट	Receipt
फ्रेम	frame
मटकी	A small earthen pot or pitcher
नाराक	Narak
गिल्की	Gilki
उन्नत	lofty
तेंदुलकर	Tendulkar
मार्जा	Marja
जून	June
अलामारिओन	Alamarion
माचके	Match
फद्दू	Faddu
हद्दियो	Haddio
जिंगी	Jingi
व्हीच	Witch
स्नेहरा	Snehra
टेको	Taco
वंत	Want
बराफ	Baraf
अब्स	Abs
बेथा	Betha
ठेंगा	thumb
अंडा	egg
तुत	You are
वाडिया	Wadia
मिलुंगी	I will meet you
पोंगा	hollow
बिगड़े	Worsened
महान	great
फरमान	Decree
कामो	Kamo
बिका	Sold out
ये	these
माम	Ma'am
नचने	Dancing
केस	hair
अक्दम	Akdam
दाई	nurse
आबाद	of place inhabited
बाबू	a respectable man
घाना	Ghana
गुलमीरा	Gulmira
हुन	Hun
पदाई	Padai
टिकेट	Ticket
श्रष्टि	Creation
आप्नु	Apnu
तुकडो	Piece
हमरे	Our
चांकी	Chunky
पर्चम	flag
इम	Im
एक्डम	Ecdem
टेस्ट	Test
कटुआ	insect which attacks rice
गुड	Good
मंगल	the planet mar
लाग	enmity
वेह	They
चार	four
प्टा	PTA
आलासिस	Alasis
प्रदर्शन	exhibiting
निर्मला	Nirmala
किज	Kij
हेमकिंग	Hemking
स्ट्रोक	stroke
गुद	anus
बाला	an ear-ornament
क्रॉड	Crood
बरती	Good-bending
अक्टन	Akton
चिंता	anxiety
वली	crease
दत्त	given
बिपक्ष	Opposition
चले	Away
कू	Ku
पाँच	the figure five
स्क्टी	Scy
अलग	detached
बाचियो	Bachio
पगली	mad woman
भगतो	Bhagto
छेत्रो	Chhetro
लगवता	Installed
भुक	Hunger
सवेरा	early morning
इश्क़	love
गुमान	conceit
चाह्ये	Want
दूँगा	'll
जबान	tongue
अम्प	Amp
मियाँ	husband
होड	bet
मेवा	fruit especially dry fruit
शीशे	Glass
नायी	New
धन्नसु	Dhanasu
कनून	Kanun
गाटर	girder
बुलाना	to call
फुकरेपन्ती	Fukrepanti
कुड	Kud
ब्लॉकबस्टर	Blockbuster
फुक	Phuk
मैन्नाशे	Mannashe
मीडिया	media
थोडा	little
दू	Give it
इलाज	remedy
सोने	Gold
तिरंगा	three-coloured
झूठ	lie
सुधिगना	Sudhigna
मेको	Meko
लापलापा	Hide
प्रतिब्न्द	Commitment
खुदखुसी	Suicide
बताने	Tell
पहाड़	mountain
लदेगी	Will fight
अडवाटे	Obstacles
जाति	nation
बताओ	Tell
स्वेटर	Sweater
गुयज़	Guyez
शुभम	Shubham
सभ	All
चालना	to sift
क्र	Has
आईयीई	IEEE
यारा	Dude,
केनी	Kenny
चुना	Chosen
बाबा	an old man
कोट्टा	Kotta
पुराना	old
रूहा	Ruha
मगाये	Ask for it
टप	cover
सुधारो	Improve
कार	Car
अल्वेज़	Alves
बजरंगे	Bajrang
चौके	Squares
हमें	To us
जिंदगी	life
ताकी	So that
बत्र	Batra
लेकिन	but
फिक्कर	Fikkar
रैपुर्किदिवा	Raipurkidiva
युगपुरुष	Man of the age or time
लाबनोलसिया	Labanolsia
मटमनो	Matmano
जादू	magic
गज्ज़ाब	Amazing
ओहू	Oahu
कार्ये	Work
वटफ	Watf
सेकंड	second
आदत	habit
सतीक	Satik
क़मीबी	Kami
आयेगी	'll
खाड़ी	bay
प्रोग्राम	program
भारा	Heavy
चलते	Go
पेश	present
सावधान	careful
पड़ता	cost price
बजाने	Playable
तत्ती	Tatti
मुशकल	Mushakal
अकदा	Akda
भरतमता	Filling up
एक्सी	Axi
ज़ारी	Continue
बरोसा	Barosa
अक्षयकनित्कर	Akshaykanitkar
अलसोग	Alsog
फस्वा	Cheating
डांग	Dang
मत्ते	Matte
योग	total
थराफ्से	Tharafse
रथ	chariot
अनक्लेजी	Unclay
जेन	Jane
होके	Hoke
इंसानंजलि	Human beings
भसद	Bhasad
निकले	Ventured
समझे	Got
जरहा	Jarha
नमन	bowing
मेज़	table
तसबीर	Picture
कुश	a sacrificial grass
सो	go to sleep
ब्रे	Bray
बक्वाश	Nonsense
कुटे	Dogs
क्रो	Crow
लकिनहमारी	But ours
ललित	fine
भांग	cannabis
ट्रिक	Tricks
टेम्मी	Tammy
गालियाँ	Abuses
नाच	dance
ह्लव	Halv
वर्जन	taboo
एक्ट	Act
मधुर	sweet
रोयाली	Royale
हामारे	Ours
जानेवाला	Going
केजू	Keju
पिले	Puppies
होना	to be
गुजर	go
कुवह	Kuwah
इस्तिफा	Resignation
रिज़	Riz
हिंदुत्व	Hindutva
रिश्ते	Relationship
अनुलाग	Attachment
रस्त	Rust
एपमैन	Epman
परिचय	introduction
शाहिद	Shahid
आगेय	Ahead
गन्ना	sugar-cane
तोमर	lance
डोन	Don
चिनाल	Chinal
सड़क	road
क्राह	Kraah
लेट	late
नारा	slogan
बोलो	Speak
लिया	took
नेई	Nei
वातवरण	Environment
हमसा	Hamsa
धर्मन्तरण	Conversion
ओवरएक्ट	Overact
आयेंगे	Will come
शरकार	Government
कैप	Cap
महिलयो	Women
बाची	Bachi
झूटे	Liars
हीन	low
दलता	Party
गंड	cheek
बर्रार्रा	Barrara
चहरे	Face
जयदा	More
बेचने	Sell
झूला	swing
बछवाड़ा	Calf
देस	country
सीरियस	Serious
इनशिर्ट	Inshirt
सूगये	Swollen
दिल	heart
मिलेज	Milage
तमाम	whole
बिलान्द	Billand
दोषी	culpable
अमारा	Amara
सुत्ता	Sutta
लाना	to bring
चलाते	Run
खरीदा	Bought
कर्वा	Karva
अर्रे	Arre
बे	Unconstrained
गुजर्जये	Pass by
बतैगा	Will tell
लेका	Leka
अनारी	Anari
एंटी	Anti
पधारे	Come on
गीक्स	Geeks
मैदान	a plain
चहती	Tea
क्रतिति	Culture
कोंसी	Which one?
निन्नी	Ninni
पहाली	See
मोहोल्ला	Mohola
कोन	cone
मेरेको	To me
इस्सी	Issy
फराक	Farak
स्वच्छ	clear
हैप्पी	Happy
पैंड	Pand
हैंन	Hann
मिन	Min
सीत	Sit down
अज	self-existent
आहूजा	Ahuja
नक्र	
हेय	petty
शिबफदकबदक	Shibffaqbadak
चेक	Czech
टवाट	Tavat
विश	Wish
यास	Yes
बडावाना	Increase
चाचाजी	Uncle,
दबकर	Pressed
सक्ती	Compulsion
नोव	Nov
अरविंद	lotus flower
सुत्तेबाज़	Suttebaz
गप्पिस्तान्रदिओ	Gossip
आभा	lustre
पुछ	Ask
यावल	Yaval
थेहिन्दु	The Hindu
इमागिने	Imagine
जन्मे	Born
कहना	to say
इमा	Ima
लाम्बा	Lamba
झोक	inclination
कोठा	Flat top or roof of a house
ख्तम	Finished
क्रेजी	Crazy
बादो	Bado
मिझे	I
साले	Brother-in-law
कैनवास	canvas
टीस	throbbing pain
जॉइन	Join
श्रीवास्तवभाई	Srivastav bhai
क्च	Kach
ट्यूम	Tum
सेक्सो	Saxo
कालू	Kalu
एहो	Eho
फर्क	disagreement
शारते	Sharte
टिंडे	Tinde
काथ	Kath
बात्ट	Butt
बजेगा	Will ring
अपन्या	Your
रंडिको	Randiko
पुछे	Ask
नवजय	Navjay
बछे	Bachhe
मारे	due to
राहूँगा	Will stay
छुपा	hidden
छेड़ते	Tease
सको	Can you
झूठे	Liars
कहदो	Say it
अटल	immovable
एंड	End
नीतियो	Policies
किद्र	Kidr
बच्च	Child
टिम	Tim
कंधे	Shoulder
थ्र	Thr
होगी	hoagy
पेला	assault
जेते	Win
मारनी	Marani
क्राना	Krana
सबक	lesson
स्लैम	Slam
जय	conquest
खोबसूरत	Beautiful
ख्तेय	
ताकेस	Takes
उमा	linseed
ज्यादातार	Mostly
घंटाबजट	Hourly Budget
हिईइइइईई	HieIeee
दुए	Duye
गंडे	Rhinoceros
पालना	to bring up
जिलात	District
उस	that
छ्र	
बतायेगा	Will tell
दखना	Look at
ओसम	Osam
आमद्मिकिसरकार	Government of India
गरम	hot
चालो	Let's go
धूपश्विनी	Dhoopswini
आरहे	Coming
हजारो	Thousands
मनो	Mano
ब्लेस	Bless
महारबानी	Maharbani
वाड्रा	Vadra
बेवकुफ	Stupid
सेट	a set of thing
मुहे	I have
विकेट	wicket
खुमारी	Khumari
पार्न्ट	Parnt
करने	To
आयसे	Aise
हमारी	Our
यंग	young
मांगनी	Ask for
क्रदी	Crunchy
काँटे	Hooks
बूंदी	Bundi
पाधे	Read
जयहिन्द	Jai Hind
मेडर	Mader
घूम	turning
भीगी	Wet
भार्ट	Bhart
चुटीयी	Chuti
कुझ	Kuz
उनकी	Their
मयंक	the moon
मैक्य	Macya
पाल	sail
योजना	plan
उखड़	Uprooted
परवाल	Parwal
सुनती	Listen to
नू	gnu
आप्किदेल्ही	Your Delhi
प्रतिओगिता	Competition
बाचे	Bache
व्हेन	Wen
मंथन	churning
थूकने	Spitting
चोर	thief
आसलियत	Reality
आशीर्वाद	blessing
हमलोग	We
ओहोह	Oh, oh
बूर	Burr
काए	What
गोला	globe
वारे	Winds
गुरुदेव	Gurudev
निई	I don't
लुकिन	Lukin
फटती	Bursting
दीदार	sight
गल्स	Gauls
जया	flag
चढ़ती	Climbs
डबरी	An earthen vessel for water
पोगो	Pogo
फ्र	Fr
रुके	Stayed
पहुचे	Reach
चड़ती	Climbing
खुन	Murder
कृपा	kindness
औगा	Auga
मुकाबला	Combat
वोहू	Wohu
आंदोलन	agitation
डोगा	Doga
स्कूल	School
अदनान	Adnan
छूट	abatement
कचरा	sweepings
हफीज	Hafeez
खुशियाँ	Happiness
कुछ	A few
किट्टी	kitty
निकलना	to come out
बताना	to tell
लेट्स	Let's
आशिक	Ashiq
क्से	Why
बन्ता	Banta
हुमाहरा	Humahra
कमन्टस	Comments
निच्ता	Certainty
फेला	Find
किट्नो	Kitno
भिन्ही	Variety
रिसल्ट	Risult
प्रोग्रेस	Progress
रणबीर	Ranbir
क्यूट	Cute
आवांग	Awang
छवि	splendour
ठंडा	cold
फेकने	Throw it away
चालिसा	Chalisa
दुवा	Link
तुम्हाई	You
प्ढे	Read
क्वस	Quas
तरफ	side
रहम	mercy
जुमा	Friday
गंजेदी	Bald
अय्य	Ayya
सीधे	straight
पेग	Peg
ड्रेस	Dress
बंगन	Brinjal
खादुस	Khadus
जलीम	Jaleem
सच	truth
जरूर्त	Need
तकबीर	Takbir
कहे	Saying
इको	Echo
गढ़र	Garhar
बंदूक	gun
आईशियन	Ician
दिललीवालों	Delhiites
रिक्वेस्ट	Request
रोल	role
हम्भी	Hambhi
डिग्रेड	Degrade
ज़रूरत	need
ज्घ	J
ह्मको	To us
पीनी	Pini
उममममम्म्म्म्म्मैम्मह	Ummmmmah
अकदुम	Akdum
नास	snuff
वरोट	Warrot
सेक्शन	section
लेजायेगा	Will take
होगिओर	Hogior
ऑनलाइन	Online
चाहिए	is necessary
लेग्टा	Legta
अप्ली	Application
वाझा	
आयेंगी	Will come
क्रुंगा	Krunga
बोथ	Both
पाकर	A kind of fig tree which has wavy leave
हमको	Us
खुशबू	fragrance
बजे	o'clock
ईंट	brick
तेओ	Teo
बॉडी	Body
भवर	Bhavar
बाध	hindrance
अबे	hey
मदार	the plant swallowwort
हमदम	a friend
रोजा	rosa
गुज़ारिश	request
शाइन	Shine
सुनाना	to tell
पालन	bringing up
पुणे	Pune
सुनके	Listen to
मल्लुम	Mallum
इज़हार	Expression
डांडा	Blackjack
अबू	Abu
डूपर	Duper
उठना	to rise
अश्लील	dirty
घुप्त्चर	Gupperture
एवा	Ava
बारसो	Barso
क्जु	Kju
अस्सलामलीकुम	Assalamalaikum
कंजूस	miserly
तांग	Tang
दुलु	Dulu
सोचता	Think
होगायी	Will be
अच्ची	True
भोपु	Bhopu
तोई	Toi
बंदा	servant
सचि	The truth
मांत्रियो	Mantrio
भागेगो	Run away
स्कता	Skatta
नेह	love
होगे	Will be
आते	Come
डक	Duck
उड़ाना	to fly
ट्वीट	tweet
वेदास	Vedas
कॉंगरॅट्स	Congregators
सौरभ	sweet smell
पिना	Pina
बनाये	Made
बजरागी	Bajrangi
अजाव	Ajav
बताएगे	Will you tell?
सम्जये	Understand
शुभकमनायें	Good luck
धुंडता	Finding
बाँधी	Tied
बुला	Calling
फायदा	profit
फ्रेंड	Friend
डिसम्बर	December
मुझ	Me
चलने	Run
हवा	air
खयाल	Think
वॉकिंग	Walking
किर्ण	Kirn
फूटने	Burst
खत्रेय	Danger
हेयर	Hair
केर	Kerr
आतंकवाड़	Terrorism
गर्ल	Girl
काम	work
लगवायी	Got it done
आग्यकारी	Obedient
सुकुन	Relax
लगातर	Continued
नेग्रो	Negro
तक्त	
चमक	glitter
गेय	singable
मने	I am
देखते	See
नुम	Num
देखेगा	See
नवाज़	Nawaz
राज्यो	States
चलायेगा	Will run
मक्कर	Makkar
लकन	Luck
डायना	Diana
बाजे	musical instruments
ह्ये	
खरीदे	Purchased
मुच्छा	Moustache
चूरू	Churu
बैठा	Sitting
तसवीर	picture
धीरे	slowly
मदत	Help
धारे	Stream
नाक	nose
क्लियर	Clear
अनुमान	guess
नासिक	Nashik
सेमा	Sema
झिन	Zin
टाटू	Tattoo
सिरापने	Sirapne
फ्रैंक	franc
अनाथ	orphan
ताकिया	Pillow
वंदे	Vande
किसकी	Whose
श	The thirtieth consonant of the Devanagari syllabary
अराही	Arahi
सेवाये	Services
टिन	tin
भरोसा	reliance
साथियो	Friends,
जेरुआर	Jeruar
ज़मिनी	Land
कीशा	Keisha
कुट्टी	chopped straw or fodder
लगायेगा	Will put
नेया	Neya
हार्ट	Heart
यहो	Yaho
सिंध	Sind
उसी	same
अगायी	Agai
देशगुजरात	Country Gujarat
ओल्डमंक	Oldmonk
बिल्ली	Cat
आत्महत्या	suicide
सुदुप	Sudup
और	and
मुर्दा	dead
आलम	the world
धेक	Dhek
शिटग	Shitag
अंध	dark
हूऊ	Hu
साई	earnest money
स्मजता	Fun
ज़माने	In times
मैनेज	Manage
पार्टिग	Parting
पीर	aged
शाबाद	Shabad
चेतन	the conscious mind
मवेशी	cattle
व्ही	V
फिट	fit
खायेगा	Will eat
असलम्वलइकुम	Aslamvalaikum
मुसे	Muse
रजत	silver
केट	Kate
अग्येई	Agyyi
खिंच	Pull
नव	new
मैरिज	Marriage
लयोगे	Layoge
सोगाये	Sleep
हैईईईईईईईईईईईई	Hieee
दरना	to grind coarsely
कुर्सी	chair
पहेन	First
अय	Ayy
चिस	Chis
कोंस	Cons
हुवा	Happened
सीखा	Learned
विशिंग	Wishing
भागेगा	Will run away
लहर	wave
वॉन	Von
गलत्कम	Wrong
भैचरे	Brotherhood
अंड	egg
मुफ्त	free
जाकय	Go
सुब्की	Subki
तुज	You
कत्तोय्ये	Cut it
बीसी	score
अल्ग	Alg
फरकी	Farki
बरसात	rain
बीप	Beep
चांस	chance
इंताजेर	Waiting
बेच	sell
समच	Just like that
त्रे	Tre
लंचर	Launcher
सोनिया	Sonia
कुशकबरी	Kushkabri
लोफर	Loafer
हव्वा	Eve
सुविधा	convenience
ज्ये	J
गुछा	Bunch
समान	common
गोध	Gods
मतलाब	I mean.
साहिल	shore
दिलों	Hearts
जहरीला	poisonous
हाड	Bone
कार्तिकेय	Kartikeya
सिमर	Simar
अंधेर	Dark
तार्ह	Tarh
ले	take
कदम	step
मुमी	Mumi
बल्ले	Bat
प्रार्थना	solcitation
डीमैग	Dmag
हेप्रभू	Hey Lord
छ्ड़ी	Stick
भ्रस्ताचार	Corruption
झलक	gleam
सफायी	Cleaning
गोबर	cowdung
हकीकत	Reality
बटे	Butte
सीता	Sita
डिटी	Diti
थोड़ी	small
सवाल	question
सर्व	all
चंद	Chand
लैला	a beloved
उत्नी	That's it
लेग्स	Legs
नामस्तेय	Namaste
नाड़ी	artery
ओहोहो	Oh yeah
शे	She
लेडीज	Ladies
कहते	Say
प्का	Pka
फेमली	Family
गगन	sky
खरीदना	buy
बनायंगे	Will make
कछुए	Turtle
कन्फ्यूज	Confusion
एक्ज़ां	Exzan
मुझी	Me
रास्त्र	The nation
बेताज़	Betaz
अभारी	Thank you
जंता	magical square
बीज	seed
दोस्ती	friendship
बार	Bar
मिलन	association
लडकिप	Girl
साबले	Sable
डुबो	merge
बोधी	Bodhi
दर्ज	entered
पगाले	Crazy
ब्बी	Bb
टर्फ	Turf
इंडो	Indo
रीयली	Really
देगे	Will give
चू	Chu
नट	dancer
रामजान	Ramadan
कीमत	value
पोपत	Popat
जबसे	Since
मिलेगा	Get
तुम्हे	To you
सुभकम्नाये	Good luck
गोडी	Sweet
कितने	How many
आनहाई	Anhai
चन्नेलवाले	Channelwale
उठाते	Take
ट्राफ	Trough
देखगे	Will see
मसीहा	messiah
मारुंगा	I will kill
कीमती	expensive
आगायी	The fire
बुद्दा	Budda
लौण्डे	Launda
साआरावधन	Sarai
खबरो	News
छोटे	Small
या	or
मंजुला	Manjula
छोड़कर	Except
लैंड	Land
बांग्लादाश	Bengali
दालो	Put it
थोकी	Thoki
ऐसेही	And so on
नाश्ता	breakfast
अनाज	grain
अमितजी	Amitji
खानी	Khani
हास	laugh
नैया	Naiya
उड़ाता	Flying
मारुगा	Maruga
क्रता	Karate
स्वागतम	welcome
बेहानो	Behno
गोइंग	Going
कमेंट	Comments
ताह	Taah
बुक	book
टाडा	Tada
कामनाये	Best wishes
भारतीय	Indian
मांगो	Ask for
गाँव	village
चाही	irrigated from a well
ओंका	Onka
महाराज	Your majesty
छुट्टी	holiday
भिजान	Bhijan
ब्रोस	Bros
रून	rune
किक	kick
निज्धं	
बोलोज	Tell me
कॉल	call
देखगा	Will see
टब	tub
गुज़ारो	Pass through
मिलुंगा	I will meet
दीजिया	Give it
क्रणी	
चलके	Let's go
गडररर	Gadarrar
अजओना	Azona
हत्याये	Murders
पेरू	Peru
ओबामा	Obama
सीफोम्ट्रक	Cefomtruck
उदेगा	Will fly
सरल	simple
सच्मे	Truth
मुर्गा	hen
फे	Fay
लोटलया	Lotlya
येक	Yek
बनानेय	To make
पगला	mad man
आनी	Be
पहले	at first
दार	wife
हाफ्टे	Weeks
दिखना	to be seen
मस्का	Musca
रॉक	rock
राचे	The
जजबा	Jajba
सेवाइसेपेशवर्ग	Service Service
अवेही	Anyway
तुमसे	with or from you
बोलने	Speaking
केस्शेथ	Caseth
बयान	law deposition
हमनी	We
चेन्नई	Chennai
जुडेगा	Will join
महिला	lady
टॉम	Tom
नो	No
ठाक	Good
जीता	alive
अजाते	Undefeated
चाडकर	Chadkar
धमकना	to shoot with pain
पेहेन्ने	Wear it
बद्द	Big
टजे	Taje
अनेती	Aneti
जिंदबाद	Zindabad
बदली	a stray cloud
चोपड़ा	Chopra
कवन	Kavan
हिट	hit
महानता	greatness
टी	Tea
दलाल	commission agent
ब्नेज	Bnage
चिपकाना	to stick
इमरैना	Imraina
पब्लिक	public
न्तर	Difference
तांगने	Tangne
सुविदा	Facility
कराओ	Do it
मोदी	grocer
मीत	friend
सुन्दत	Beautiful
बिल	Bill
करता	Does
करर	Karr
होकर	By
फूफा	Uncle
उधबीलाओ	Rise up
नाए	Not
जरुरथ	Need
हिंगलिश	Hinglish
सुभा	Subha
घुमना	roll
कारा	prison
हुआ	happened
नागा	nude ascetic
पकड़	grasp
जिसकी	Whose
हिंदुस्तान	Hindustan
कैलेजा	Calleja
रेप्लिय्य	Replica
अमो	Amo
जैगी	Jaggi
सुनु	Sunu
झाँसी	Jhansi
रुती	Ruti
पुरा	total
हिंदभारट	Hind Bharat
जोरो	Joro
काकरोच	cockroach
स्वच	Clean
हल्लाल	Halal
राजा	reign
ब्लैक	Black
रालेगन	Ralegan
सुध	happened
रहियो	Stay
तामिक	Tamic
मुगे	Me
बेहंजी	Behenji
बानिये	Become a
गढ़हाई	Garhhai
चंदी	Chandi
नमशकर	Hello
डेकना	Decana
आले	Came
सानु	a mountain
ह्यू	Hue
भैईइईईईई	Brother,
पा	take
कोलाज	collage
करे	Do it
बोलना	to speak
पक्की	Paved
बाखी	Bakhi
किथे	Where
जसे	Such as
वादों	Promises
बेकर	baker
एबी	Ab
आसमियुन	Asmiyun
बाच	Bach
लॉन्ग	Long
खुल	open
अपान	intestinal wind
शिव्या	Abuse
लाओ	Lao
दोस्तों	Friends
पूजता	Worship
बाहुर	Bahur
राष्ट्रीय	national
रोयेगी	Will cry
पहुँचेगा	Will
तो	at that time
ओरिजेंल	Original
चूजा	chick
नहाई	Not
डोना	Small cup or bowl made of leave
मिष्टके	Mishtke
ईड	Ed
घजब	Ghajab
हर्ट	Hurt
खाड़ा	Steep
सॉलिड	Solid
साफ	clean
क्वेस	Quess
जान्ना	Janna
इसने	It
उसमे	therein
पिचवारे	Pitches
परिष्ड	Refined
भैजन्न	Brother
भदवे	Bhadwe
पिलुरा	Pilura
हमसी	We
वन्हा	
साइट	site
सलामत	safe
सैम	Sam
चड़े	Climbing
फोरगेट	Forget
उपा	Upas
गुंडा	hooligan
इन्तिहा	Intiha
आइस्के	Iceke
पेट	belly
साहेर	Saher
सांसे	Breathe
जागा	awakening
ज्यिस	Jyis
अनीसे	Anise
में	In
हॉर्न	horn
केर्डो	Kerdo
कामने	Work
इबादत	worship
भैलोग	Brothers
प्टेन	Pten
क्रती	Kruti
तुस्सी	Tussi
मानवजीवन	Human Life
पठानी	wife of a Pathan
पज्जी	Pajji
मुज्से	From me
भोकल	Bhokal
औकाद	Aukad
बताया	Told
ब्ताया	Tell me
क्रिकबुज़	Cricbuzz
पठाको	Pathako
पेस	Pace
कुटलू	Kutlu
सास्टे	Cheap
पड़ियो	Read on.
अनमोल	priceless
कच्छुआ	Turtle
क्यारी	flower bed
भा	splendor
जॉय	Joey
जाये	Go
यीईएई	Yiaeee
उदय	rise
चान्द	The Moon
इंको	Inco
बॉलीवुड	Bollywood
क्मलन	Kamalan
अक	A k
बाही	Arm
किस	what
टायर	tyre
सपने	Dreams
नौ	the figure nine
भाला	spear
बायबल	Bible
आखिरकार	After all
क्ष	Q
बालने	Balne
संस्यये	Problems
आशा	hope
एरीया	Area
नासम	Nasam
सिंगल	single
प्या	Drink
भूपिंदर	Bhupinder
राजस्थान	Rajasthan
असलील	Real
सिंस	Sins
बखत	good fortune
कात	Cut
चपड	Slippers
मिट्रोएँ	Mitroen
सुरे	Surre
आराम	rest
अधिकारियो	Officers
पसंद	likable
ह	The thirty-third consonant of the Devanagari syllabary
कन	particle
होई	Yes
विलिस	Willis
लाला	A respectful designation especially for a trader or businessman
लूटे	Robbed
जायें	Go
आका	Mentor
भेने	Bhene
आदतेन	Habit
वो	That
त्ब्यत	Tbyat
बाड़ियाँ	Fences
आजो	Ajo
दर्म	Derm
जानती	Know
बुलाटिन	Bulatin
डॉलर	dollar
माज़ा	Fun
सुपारी	betel nut
अग	Aug
लिखो	Write
आहाहाहहाहाहा	Ahhahahahahaha
रोया	Cried
समलखे	Understand
नवर	The new
मम्मी	mummy
धन	wealth
हमे	We
स्मझा	
देके	Look at
जिन्होने	Who
फेक्टरी	Factory
पाढ़ाओ	Read
भूखा	hungry
निशान	mark
माथ्स	Maths
सलमान	Salman
लाइन	line
मुन्ना	Tot
जुब	Jub
चालीसा	An aggregate of forty articles
वाहियाद	Wahiyad
होजाएँगे	Will be done
रिहा	freed
वाएगुरुजी	Y.A. Guruji
पढ़ने	Read
कासत्ते	Kastya
दरिया	river
खेत	field
किल्लफ	Kilf
लड़का	boy
कोसम	Kosam
अजिंक्य	Ajinkya
स्बकी	Sbaki
बिसा	Bisa
अवियान	Avian
अखिरत	Finally,
पकडे	Caught
मधरचोड़	Madharchod
वक	heron
जयगी	Jaygi
विवा	Viva
कोहिनूर	Kohinoor
खुशखबरी	Good news
हिंदुस्तानी	Indian
फीवर	Fever
सीखेगा	Will learn
जयहिंद	Jaihind
तालियाओ	Taliao
बदया	Badya
जिधर	where
ज़ाकत	Zakat
क्लोई	Chloe
डोली	small sedan or palanquin
नौनिहालो	Young man
खा	eat
देदिजीये	Give it
लोक	people
नाम	name
अजा	she-goat
सुसरे	Susre
सल्मान	Salman
जमीनो	Land
पाइन	Pine
धूल	dust
मिसिंग	Missing
नार्क	Hell
सोइयो	Soyo
ठाणे	Thane
गावा	Village
फन्ना	Fanna
चलावी	Run
शाक	vegetable
काटो	Bite
हाइना	Hyena
पाकी	Pakistani
ताभ	then
छ्ता	umbrella
बकचोडी	nonsense
होती	would have
कट्टा	gun
तीक	sharp
लागाय	planted
छ्क्र	circle
नेचे	below
ज्न्गलतमैट्व	wildness
संभला	keep one's feet
होते	would have
स्म्भल	steady
आगाय	forward
ज्येगी	will live
छ्ल	deceit
वजे	o'clock
लीय	taken
बकवास	Nonsense
मदरचोड़	mother-fucker
चूटिया	foolish
होजता	would have